あいじょうかれん	愛城華恋	名詞	
あいばあいな	相羽あいな	名詞	
いくたてる	生田暉	名詞	
いするぎふたば	石動双葉	名詞	
いとうあやさ	伊藤彩沙	名詞	
いわたはるき	岩田陽葵	名詞	
かぐらひかり	神楽ひかり	名詞	
かれん	華恋	名詞	
きりん	キリン	名詞	
こいのまきゅう	恋の魔球	名詞	
こやまももよ	小山百代	名詞	
さいじょうくろでぃーぬ	西條クロディーヌ	名詞	
ざすたぁのうん	The Star Known	名詞	
さとうひなた	佐藤日向	名詞	
じゅんな	純那	名詞	
しょうじょかげきれゔゅーすたぁらいと	少女歌劇レヴュースタァライト	名詞	
すたぁらいと	スタァライト	名詞	
すたぁらいとくくぐみ	スタァライト九九組	名詞	
せいしょうおんがくがくいん	聖翔音楽学園	名詞	
せかいをはいにするまで	世界を灰にするまで	名詞	
だいばなな	大場なな	名詞	
つだけんじろう	津田健次郎	名詞	
つゆざきまひる	露崎まひる	名詞	
てんどうまや	天堂真矢	名詞	
とみたまほ	富田麻帆	名詞	
はなさかうた	花咲か唄	名詞	
はなやぎかおりこ	花柳香子	名詞	
ぶたいしょうじょ	舞台少女	名詞	
ふらいみーとぅーざすたぁ	Fly Me to The Star	名詞	
ほこりとおごり	誇りと驕り	名詞	
ぽじしょんぜろ	ポジションゼロ	名詞	
ほしつみのうた	星摘みの歌	名詞	
ほしのだいあろーぐ	星のダイアローグ	名詞	
ほしぼしのきずな	星々の絆	名詞	
ほしみじゅんな	星見純那	名詞	
みもりすずこ	三森すずこ	名詞	
りくりえいと	RE:CREATE	名詞	
れゔゅー	レヴュー	名詞	
れゔゅーすたぁらいと	レヴュースタァライト	名詞	
