4u	４U	名詞	
Alotoflife	A lot of life	名詞	
Discoveruniverse	Discover Universe	名詞	
Happymusic	Happy Music♪	名詞	
Makesumenoise	Make some noise!	名詞	
prayers	prayer[s]	名詞	
Wishyouluck	Wish You Luck	名詞	
あいえぬじー	ING	名詞	
あいもとりんく	愛本りんく	名詞	
あおい	葵依	名詞	
あおやぎつばき	青柳椿	名詞	
あかしまほ	明石真秀	名詞	
あっぴーあらうんど	Happy Around!	名詞	
あろっとおぶらいふ	A lot of life	名詞	
いずもさき	出雲咲姫	名詞	
いぬよせしのぶ	犬寄しのぶ	名詞	
いぶき	衣舞紀	名詞	
うぃっしゅゆーらっく	Wish You Luck	名詞	
えそら	絵空	名詞	
おおなるとむに	大鳴門むに	名詞	
かすがはるな	春日春奈	名詞	
がなびーらいと	Gonna be right	名詞	
かれんでゅら	カレンデュラ	名詞	
きみにはぴあれ	君にハピあれ♪	名詞	
きょうこ	響子	名詞	
ぎんがてつどうのよるに	銀河鉄道の夜に	名詞	
くるみ	胡桃	名詞	
こずみっくこーすたー	Cosmic CoaSTAR	名詞	
さいちょうてんぴーきーあんどぴーきー	最頂点Peaky&Peaky!!	名詞	
さき	咲姫	名詞	
さくらだみゆ	桜田美夢	名詞	
ささごじぇにがーゆか	笹子・ジェニファー・由香	名詞	
しみずえそら	清水絵空	名詞	
しゅんどうむーぶめんと	瞬動 -movement-	名詞	
しらとりくるみ	白鳥胡桃	名詞	
せとりか	瀬戸リカ	名詞	
だいれくとどらいぶ	Direct Drive!	名詞	
たけしたみいこ	竹下みいこ	名詞	
つきみやまなぎさ	月見山渚	名詞	
でぃぐでぃらいと	Dig Delight!	名詞	
でぃすかばーゆにばーす	Discover Universe	名詞	
でんらんかうんとだうん	電乱★カウントダウン	名詞	
とげつれい	渡月 麗	名詞	
とわ	乙和	名詞	
にいじまいぶき	新島衣舞紀	名詞	
にるゔぁな	ニルヴァナ	名詞	
はっぴーみゅーじっく	Happy Music♪	名詞	
はなまきとわ	花巻乙和	名詞	
はるな	春奈	名詞	
ひぁずざらいと	Here's the light	名詞	
ひいろ	緋彩	名詞	
ひだかさおり	日高さおり	名詞	
ぴっきーぴーきー	Peaky P-key	名詞	
ふぉーゆー	４U	名詞	
ふぉとんめいでん	Photon Maiden	名詞	
ふぉとんめろでぃーず	Photon Melodies	名詞	
ふくしまのあ	福島ノア	名詞	
ぷれいやーず	prayer[s]	名詞	
ふろあきらー	Floor Killer	名詞	
ほらいぞんたるおーす	Horizontal Oath	名詞	
まーめいど	Merm4id	名詞	
まつやまだりあ	松山ダリア	名詞	
まほ	真秀	名詞	
まりか	茉莉花	名詞	
みずしままりか	水島茉莉花	名詞	
みやけあおい	三宅葵依	名詞	
みゆ	美夢	名詞	
めいくさむのいず	Make some noise!	名詞	
やのひいろ	矢野緋彩	名詞	
やまてきょうこ	山手響子	名詞	
ゆか	由香	名詞	
よごれっちまったかなしみのいろ	汚れっちまった悲しみの色	名詞	
らうんどあんどらうんど	round and round	名詞	
りりかるりりぃ	Lyrical Lily	名詞	
れい	麗	名詞	
れっつどぅざびっぐばん	Let's do the ‘Big-Bang!’	名詞	
ろんど	燐舞曲	名詞	
わがはいよねこであれ	吾輩よ猫であれ	名詞	
わっとあーゆー	“What” are you?	名詞	
