Ambitiouseve	Ambitious Eve	名詞	
Bloomy	Bloomy!	名詞	
Damascuscocktail	Damascus Cocktail	名詞	
Darlingyou	Darling you!	名詞	
Daybreakage	Daybreak Age	名詞	
Dyethesky	Dye the sky.	名詞	
Futuritysmile	FUTURITY SMILE	名詞	
Goingmyway	Going my way	名詞	
Harebare	HAREBARE!!	名詞	
Letsgetachance	Let's get a chance	名詞	
Loveaddiction	Love Addiction	名詞	
Multicoloredsky	Multicolored Sky	名詞	
Neotheoryfantasy	NEO THEORY FANTASY	名詞	
Shhis	SHHis	名詞	
Snowflakesmemories	SNOW FLAKES MEMORIES	名詞	
Sokarway	SOLAR WAY	名詞	
SOS	SOS	名詞	
Spreadthewing	Spread the Wings!!	名詞	
Sweetmemories	Sweet Memories	名詞	
Sweetstep	SWEET♡STEP	名詞	
Transcendingtheworld	Transcending The World	名詞	
Wanderingdreamchaser	Wandering Dream Chaser	名詞	
Wecangonow	We can go now!	名詞	
あいあいがくしゃ	相合学舎	名詞	
あおぞらさいだー	あおぞらサイダー	名詞	
あけた	緋田	名詞	
あけたみこと	緋田美琴	名詞	
あさくらとおる	浅倉透	名詞	
あぽいんとしぐなる	アポイント・シグナル	名詞	
あまい	天井	名詞	
あまいつとむ	天井努	名詞	
あまな	甘奈	名詞	
ありすがわなつは	有栖川夏葉	名詞	
ありったけのかがやきで	ありったけの輝きで	名詞	
あるすとろめりあ	アストロメリア	名詞	
あるすとろめりあ	アルストロメリア	名詞	
あるすとろめりあ	ALSTROMERIA	名詞	
あんてぃーか	アンティーカ	名詞	
あんてぃーか	L'Antica	名詞	
あんびしゃすいぶ	Ambitious Eve	名詞	
いかるがるか	斑鳩るか	名詞	
いずみめい	和泉愛依	名詞	
いそべかりん	礒部花凜	名詞	
いちかわひなな	市川雛菜	名詞	
いつかShinydays	いつか Shiny Days	名詞	
いつかしゃいにーでいず	いつか Shiny Days	名詞	
いるみねーしょんすたーず	イルミネーションスターズ	名詞	
いるみねーしょんすたーず	Illumination STARS	名詞	
うぃーきゃんごーなう	We can go now!	名詞	
えすおーえす	SOS	名詞	
おおさきあまな	大崎甘奈	名詞	
おおさきてんか	大崎甜花	名詞	
おかさきみほ	岡咲美保	名詞	
かざのひおり	風野灯織	名詞	
かじゅんせいぶりーち	過純性ブリーチ	名詞	
かほ	果穂	名詞	
からーでいず	Color Days	名詞	
からふるふぇざー	COLORFUL FE@THERS	名詞	
かわぐちりな	川口莉奈	名詞	
きすいしお	希水しお	名詞	
きたはらさやか	北原沙弥香	名詞	
きらーみっしょん	Killer×Mission	名詞	
きりこ	霧子	名詞	
ぐらでーとういんぐ	GR@DATE WING	名詞	
くろきほのか	黒木ほの香	名詞	
くわやまちゆき	桑山千雪	名詞	
げんわくSilhouette	幻惑SILHOUETTE	名詞	
げんわくしるえっと	幻惑SILHOUETTE	名詞	
こいと	小糸	名詞	
こうのひより	河野ひより	名詞	
ごーいんぐまいうぇい	Going my way	名詞	
こがね	恋鐘	名詞	
こみやかほ	小宮果穂	名詞	
こんどうれいな	近藤玲奈	名詞	
さいじょうじゅり	西城樹里	名詞	
さくや	咲耶	名詞	
さくらぎまの	櫻木真乃	名詞	
しーくれっとゆーとぴあ	Secret utopIA	名詞	
しーず	SHHis	名詞	
じーずなるういんたー	SE@SONAL WINTER	名詞	
しづきあずさ	紫月杏朱彩	名詞	
しばさきのりこ	芝崎典子	名詞	
しゃいのぐらふぃ	シャイノグラフィ	名詞	
しゃにます	シャニマス	名詞	
じゅり	樹里	名詞	
しらいしはるか	白石晴香	名詞	
しらせさくや	白瀬咲耶	名詞	
しんせさいど	Synthe-Side	名詞	
すいーとすてっぷ	SWEET♡STEP	名詞	
すいーとめもりーず	Sweet Memories	名詞	
すがぬまちさ	菅沼千紗	名詞	
すずもとあきほ	涼本あきほ	名詞	
すたーちす	statice	名詞	
すてら	Stella	名詞	
すとれいらいと	ストレイライト	名詞	
すとれいらいと	Straylight	名詞	
すのーふれーくすめもりーず	SNOW FLAKES MEMORIES	名詞	
すぷれっどざういんぐ	Spread the Wings!!	名詞	
すろーもーしょん	スローモーション	名詞	
せきねひとみ	関根瞳	名詞	
せつげつふうか	雪・月・風・花	名詞	
ぜったいせいぎえぶりでい	絶対正義 EVERY DAY	名詞	
せりざわあさひ	芹沢あさひ	名詞	
せんやありあ	千夜アリア	名詞	
そーらーうぇい	SOLAR WAY	名詞	
そのだちよこ	園田智代子	名詞	
そる	Sol	名詞	
だーりんゆー	Darling you!	名詞	
だいざすかい	Dye the sky.	名詞	
たいようきっす	太陽キッス	名詞	
たじまさらん	田嶌紗蘭	名詞	
たそがれあいでんてぃてぃー	誰ソ彼アイデンティティー	名詞	
たなかまみみ	田中摩美々	名詞	
たなかゆき	田中有紀	名詞	
だますかすかくてる	Damascus Cocktail	名詞	
ちーむすてら	Team.Stella	名詞	
ちーむそる	Team.Sol	名詞	
ちーむるな	Team.Luna	名詞	
ちゆき	千雪	名詞	
ちよこ	智代子	名詞	
ちょこれーとさんでー	チョコデート・サンデー	名詞	
つきおかこがね	月岡恋鐘	名詞	
つちやりお	土屋李央	名詞	
つばさぷろだくしょん	283プロダクション	名詞	
でいぶれいくえいじ	Daybreak Age	名詞	
でびたろうのうた	デビ太郎のうた	名詞	
てんか	甜花	名詞	
とおる	透	名詞	
とこさきのにわ	常咲の庭	名詞	
とらいあんぐる	トライアングル	名詞	
とらんせんでぃんぐざわーるど	Transcending The World	名詞	
ながいまりこ	永井真理子	名詞	
なつは	夏葉	名詞	
ななくさにちか	七草にちか	名詞	
ななくさはづき	七草はづき	名詞	
にじになれ	虹になれ	名詞	
にじのゆくえ	虹の行方	名詞	
にちか	にちか	名詞	
ねおせおりーふぁんたじー	NEO THEORY FANTASY	名詞	
のくちる	ノクチル	名詞	
のくちる	noctchill	名詞	
はちみやめぐる	八宮めぐる	名詞	
はなまるばっじ	ハナマルバッジ	名詞	
ぱのらまういんぐ	PANOR@MA WING	名詞	
はぴりり	ハピリリ	名詞	
ばべるしてぃぐれいす	バベルシティ・グレイス	名詞	
はればれ	HAREBARE!!	名詞	
びーちぶれいばー	ビーチブレイバー	名詞	
ひおり	灯織	名詞	
ひかりのdestination	ヒカリのdestination	名詞	
ひかりのですてぃねいしょん	ヒカリのdestination	名詞	
ひぐちまどか	樋口円香	名詞	
ひなな	雛菜	名詞	
ふくまるこいと	福丸小糸	名詞	
ふゅーちゃりてぃすまいる	FUTURITY SMILE	名詞	
ふゆこ	冬優子	名詞	
ふらぐめんとういんぐ	FR@GMENT WING	名詞	
ぷらすちっくあんぶれら	プラスチック・アンブレラ	名詞	
ぷらにすふぃあ	プラニスフィア ～planisphere～	名詞	
ぷらにすふぃあ	プラニスフィア	名詞	
ぷらにすふぃあ	planisphere	名詞	
ぶりりあんとういんぐ	BRILLI@NT WING	名詞	
ぶるーみー	Bloomy!	名詞	
ほうかごくらいまっくすがーるず	放課後クライマックスガールズ	名詞	
ほうくら	放クラ	名詞	
ほしをめざして	星をめざして	名詞	
まえかわりょうこ	前川涼子	名詞	
またあした	また明日	名詞	
まどか	円香	名詞	
まの	真乃	名詞	
まみみ	摩美々	名詞	
まゆずみふゆこ	黛冬優子	名詞	
まるちからーどすかい	Multicolored Sky	名詞	
まるやまわかな	丸山和佳奈	名詞	
みこと	美琴	名詞	
みつみねゆいか	三峰結華	名詞	
みねだまゆ	峯田茉優	名詞	
めい	愛依	名詞	
もりのりんぜ	杜野凛世	名詞	
やまきあんな	八巻アンナ	名詞	
やまねあや	山根綺	名詞	
ゆいか	結華	名詞	
ゆいなみづき	結名美月	名詞	
ゆうこくきりこ	幽谷霧子	名詞	
ゆきむらえり	幸村恵理	名詞	
ゆめさきAfterschool	夢咲きAfter school	名詞	
ゆめさきあふたーすくーる	夢咲きAfter school	名詞	
ゆめみどり	夢見鳥	名詞	
よりみちさんせっと	よりみちサンセット	名詞	
らびりんすれじすたんす	ラビリンス・レジスタンス	名詞	
らぶあでぃくしょん	Love Addiction	名詞	
りふれくとさいん	リフレクトサイン	名詞	
りんぜ	凛世	名詞	
るな	Luna	名詞	
れいやーどういんぐ	L@YERED WING	名詞	
れぞなんすぷらす	Resonance⁺	名詞	
れっつげっとあちゃんす	Let's get a chance	名詞	
わくいゆう	和久井優	名詞	
わたしのしゅじんこうはわたしだから	わたしの主人公はわたしだから！	名詞	
わんだりんぐどりーむちぇいさー	Wandering Dream Chaser	名詞	
