あいこおおい	AIKO OI	名詞	
あいしくるす	Icicles	名詞	
あいず	3y3s	名詞	
あいむそう	愛無双	名詞	
あおのせんりつ	蒼の旋律	名詞	
あかとあおのらんぺーじ	朱と碧のランページ	名詞	
あきらやまおか	AKIRA YAMAOKA	名詞	
あくうかんゆうえい	亜空間遊泳ac12.5	名詞	
あくた	Akhuta	名詞	
あけこん	アケコン	名詞	
あさだやすし	浅田靖	名詞	
あさみゆういち	浅見祐一	名詞	
あすとらいあのそうべい	アストライアの双皿	名詞	
あなざーふぇいず	Another Phase	名詞	
あにきさす	Anisakis	名詞	
あばれほむら	暴レ焔	名詞	
あびす	Abyss	名詞	
あぶさーどがふ	Absurd Gaff	名詞	
あぺんどとらべる	APPEND TRAVEL	名詞	
あぺんどふぇすてぃばる	APPEND FESTIVAL	名詞	
あまるがめーしょん	Amalgamation	名詞	
あめと	天土	名詞	
あるけー	αρχη	名詞	
あるびだ	ALBIDA	名詞	
あるまげすと	Almagest	名詞	
あんぎゃおう	行脚王	名詞	
あんだーこんとろーる	under control	名詞	
あんりみてっどふぁいやー	UNLIMITED FIRE	名詞	
いおしす	IOSYS	名詞	
いかろす	ICARUS	名詞	
いくさ	Xa	名詞	
いごうぜろがた	イ号零型	名詞	
いしかわたかゆき	石川貴之	名詞	
いずみいぶき	和泉一舞	名詞	
いずみむつひこ	泉陸奥彦	名詞	
いちきり	1切り	名詞	
いどら	Idola	名詞	
いまなんど	今何℃？	名詞	
いれーざーふぁんとむ	eRAseRmOToRpHAntOM	名詞	
いんそむにあ	INSOMNIA	名詞	
うおひにのぼりかがよいて	魚氷に上り 耀よひて	名詞	
うちゅうさむらい	宇宙SAMURAI	名詞	
うちょうてんびばーちぇ	有頂天ビバーチェ	名詞	
うめゆきよ	梅雪夜	名詞	
えあーれいどふろむざあんだーぐらうんど	AIR RAID FROM THA UNDAGROUND	名詞	
えいんへりやる	Einherjar	名詞	
えきべん	EkiBEN	名詞	
えくすしあ	EXUSIA	名詞	
えくすとら	EXTRA	名詞	
えくすとりーむぐれーど	X-treme Grade	名詞	
えくせ	エクセ	名詞	
えでぃっと	EDIT	名詞	
えでん	EDEN	名詞	
えばーらすてぃんぐりぞーと	Everlasting Resort	名詞	
えりしゃ	Elisha	名詞	
えるぴす	ΕΛΠΙΣ	名詞	
えれめんたるくりえーしょん	Elemental Creation	名詞	
えんかうんたー	encounter	名詞	
えんぐれいぶどまーく	Engraved Mark	名詞	
えんどるふぃん	エンドルフィン	名詞	
えんぷれす	EMPRESS	名詞	
えゔぁんす	Evans	名詞	
えーてる	ÆTHER	名詞	
おこめたる	お米の美味しい炊き方、そしてお米を食べることによるその効果。	名詞	
おすたたかえおうえんだん	押忍!闘え!応援団	名詞	
おすたーぷろじぇくと	OSTER project	名詞	
おせんじゅめでぃてーしょん	御千手メディテーション	名詞	
おとげー	音ゲー	名詞	
おにがみ	鬼天	名詞	
おにひめ	鬼姫	名詞	
おのけん	onoken	名詞	
おのひでゆき	小野秀幸	名詞	
おふろっく	オフ♨ロック	名詞	
おぼろ	朧	名詞	
おまーじゅ	Hommarju	名詞	
おるぱ	オルパ	名詞	
おーだいん	大打音	名詞	
おーと	AUTO	名詞	
おーばーぜあー	over there	名詞	
おーばーびゅーず	overviews	名詞	
かいざーふぇにっくす	KAISER PHOENIX	名詞	
かおす	CHAOS	名詞	
かがち	蛇神	名詞	
かげきよ	KAGEKIYO	名詞	
かげんのつき	下弦の月	名詞	
かしょくせいあいどるしょうこうぐん	過食性:アイドル症候群	名詞	
かすがさきこ	春日咲子	名詞	
かっこいい	[E]	名詞	
かっと	CUT	名詞	
かふぇどとらん	Café de Tran	名詞	
かぷさいしん	C18H27NO3	名詞	
かめんぶれいく	KHAMEN BREAK	名詞	
からげーじ	辛ゲージ	名詞	
からぷあ	空プア	名詞	
からみてぃふぇにっくす	CALAMITY PHOENIX	名詞	
かりきゅれーたー	Calculator	名詞	
かーねーしょん	和蘭撫子	名詞	
がいあ	GAIA	名詞	
がんぼる	GAMBOL	名詞	
ききごたえばつぐん	聴きごたえ抜群	名詞	
きめら	CHIMERA	名詞	
きものぷりんせす	KIMONO♡PRINCESS	名詞	
きゃとられこいはもーもく	キャトられ♥恋はモ〜モク	名詞	
きゃぷてぃべいと	CaptivAte	名詞	
きゃんでぃ	candii	名詞	
きゅうびこやぎょう	九尾狐夜行	名詞	
きょうか	響香	名詞	
きょうふのうのうかいかく	恐怖の右脳改革	名詞	
きょくしょなん	局所難	名詞	
きらしゃくねつのさばき	煌-灼熱の裁き-	名詞	
きーぼーどまにあ	KEYBOARDMANIA	名詞	
ぎがでりっく	gigadelic	名詞	
ぎがぶれいく	GIGA BREAK	名詞	
ぎたどら	GITADORA	名詞	
ぎたーひーろー	Guitar Hero	名詞	
ぎたーふりーくす	GuitarFreaks	名詞	
ぎゃくぼ	逆ボ	名詞	
くうそう	空葬	名詞	
くえーさー	quasar	名詞	
くえーばー	quaver♪	名詞	
くりあらー	クリアラー	名詞	
くりすぴー	Qrispy joybox	名詞	
くるいざけほむらのはな	狂イ咲ケ焔ノ華	名詞	
くるぱ	クルパ	名詞	
くろ	96	名詞	
くろかみみだれししゅらとなりて	黒髪乱れし修羅となりて	名詞	
くろさわだいすけ	黒沢ダイスケ	名詞	
くろすびーつ	CROSS×BEATS	名詞	
くろすびーつ	クロスビーツ	名詞	
くろちゃん	96ちゃん	名詞	
くろのす	Chronos	名詞	
くろふめん	黒譜面	名詞	
くろめん	黒麺	名詞	
くーる	COOL	名詞	
ぐっくる	good-cool	名詞	
ぐど	グド	名詞	
ぐるーゔぃん	groovin'!!	名詞	
ぐるーゔぃー	GUHROOVY	名詞	
ぐるーゔこーすたー	GROOVE COASTER	名詞	
ぐるーゔこーすたー	グルーヴコースター	名詞	
ぐれ	グれ	名詞	
ぐれんのほのお	紅蓮の焔	名詞	
げきしょう	激唱	名詞	
げきだんれこーど	劇団レコード	名詞	
げきてい	ゲキテイ	名詞	
げきれこ	劇レコ	名詞	
げんそうけいせかいしゅうふくしょうじょ	幻想系世界修復少女	名詞	
こいするうちゅうせんそう	恋する☆宇宙戦争っ!!	名詞	
こいはどうもろはどうおーけーほうていしき	恋はどう?モロ◎波動OK☆方程式!!	名詞	
こえづかよしひこ	肥塚良彦	名詞	
こくうとこうみょうのでぃすくーる	虚空と光明のディスクール	名詞	
こさかりゆ	小坂りゆ	名詞	
こなすた	コナスタ	名詞	
こぴおす	copious	名詞	
これっと	colette	名詞	
こんちぇるてぃのいんぶるー	Concertino in Blue	名詞	
こんふれ	混フレ	名詞	
こんぼ	COMBO	名詞	
こーすけ	kors k	名詞	
ごけん	五鍵	名詞	
ごーびよんど	Go Beyond!!	名詞	
ごーるどらっしゅ	GOLD RUSH	名詞	
さいたす	Cytus	名詞	
さうんどぼるてっくす	SOUND VOLTEX	名詞	
さきこ	咲子	名詞	
ささきひろふみ	佐々木博史	名詞	
さどぅん	SUDDEN	名詞	
さな	Sana	名詞	
さまーほりでい	Summer Holiday	名詞	
さむらいろけっと	SAMURAI ROCKET	名詞	
さむらん	侍乱	名詞	
さよならすーぱーすたー	SA.YO.NA.RA. SUPER STAR	名詞	
さるかねがっせん	去る金合戦	名詞	
さんきゅーふぉーゆーえーしーぜろぜろ	3Q-4U-AC00	名詞	
さんじゅうにぶ	32分	名詞	
さんだーぼると	Thunderbolt	名詞	
さんばいあいすくりーむ	三倍アイスクリーム	名詞	
さんばであみーご	サンバDEアミーゴ	名詞	
ざかーにばらすかーにばる	The Carnivorous Carnival	名詞	
しあとりずむ	シアトリズム	名詞	
しお	shio	名詞	
しおん	SHION	名詞	
しぐしぐ	SigSig	名詞	
しっく	S!ck	名詞	
しののめここな	東雲心菜	名詞	
しののめなつひ	東雲夏陽	名詞	
しぶ	4分	名詞	
しみずたつや	清水達也	名詞	
しめどれー	〆ドレー	名詞	
しもつきりん	霜月凛	名詞	
しゃくねつびーちさいどばにー	灼熱Beach side Bunny	名詞	
しゃっふる	SHUFFLE	名詞	
しゅんぷうぶろーいんうぃんど	春風ブローインウィンド	名詞	
しゅんゆう	春遊	名詞	
しょこう	曙光	名詞	
しょっくあろー	SHOCK ARROW	名詞	
しょっちょー	ショッチョー	名詞	
しょーばいろっく	SHOW BY ROCK	名詞	
しりうす	SIRIUS	名詞	
じゃかるたふぁんくぶらざーず	ジャカルタファンクブラザーズ	名詞	
じゃすとだんす	JUST DANCE	名詞	
じゃんくしょん	junction	名詞	
じゅうにぶ	12分	名詞	
じゅうろくぶ	16分	名詞	
じゅん	jun	名詞	
じょうねつふぁんふぁん	情熱fun!fun!	名詞	
じょうぶつにせん	万戈イム－一ノ十	名詞	
じょまんだ	JOMANDA	名詞	
すいしょくこまちめらんこりあ	衰色小町メランコリア	名詞	
すいーといりゅーじょん	Sweet Illusion	名詞	
すいーとれいん	Sweet Rain	名詞	
すくふぇす	スクフェス	名詞	
すこあらー	スコアラー	名詞	
すこーる	squall	名詞	
すたーびんぐとらんさー	Starving Trancer	名詞	
すたーらいとふぁんたじあ	Starlight Fantasia	名詞	
すてっぷまにあ	StepMania	名詞	
すてるす	STEALTH	名詞	
すとぅるてぃ	STULTI	名詞	
すのはれ	スノハレ	名詞	
すのーぐーす	Snow Goose	名詞	
すのーすとーむ	snow storm	名詞	
すのーぷりずむ	snow prism	名詞	
すぱらん	S乱	名詞	
すぱらん	スパラン	名詞	
すぱーだ	SPADA	名詞	
すぺちゃん	スペチャン5	名詞	
すみだがわかれんか	隅田川夏恋歌	名詞	
すむーち	smooooch・∀・	名詞	
すーぱーすたーみつる	SUPER STAR 満-MITSURU-	名詞	
せかんどへぶん	Second Heaven	名詞	
せつげつか	雪月花	名詞	
せりか	セリカ	名詞	
せんぷうのまい	旋風ノ舞	名詞	
せんぷうのまい	旋風ノ舞【地】	名詞	
せんぷうのまい	旋風ノ舞【天】	名詞	
せんぼんまつじん	千本松仁	名詞	
ぜいへん	蛻変	名詞	
ぜっつー	ZZ	名詞	
ぜふぁー	Xepher	名詞	
ぜろののくたーん	零の夜想曲	名詞	
ぜんおし	全押し	名詞	
そうりゅうのらん	双竜ノ乱	名詞	
そくしんじょうぶつ	Sol Cosine Job 2	名詞	
そらにあがないおつるとも	空に抗い堕つるとも	名詞	
そるげ	ソルゲ	名詞	
そろばん	十露盤	名詞	
そんね	Sonne	名詞	
そーさー	saucer	名詞	
そーたふじもり	Sota Fujimori	名詞	
たいくーん	TYCOON	名詞	
たいこざむらい	太鼓侍	名詞	
たいこのたつじん	太鼓の達人	名詞	
たいむかぷせるらぼ	TIME CAPSULE Lab.	名詞	
たいむぴーすふぇーずつー	Timepiece Phase II	名詞	
たか	dj TAKA	名詞	
たかはしさん	タカハシサン	名詞	
たかはしさん	タカハシさん	名詞	
たかはしさんらぼ	タカハシサンラボ	名詞	
たぐ	TAG	名詞	
ただよし	TA・DA☆YO・SHI	名詞	
たっしゅ	Tatsh	名詞	
たつみめぐみ	達見恵	名詞	
たてれん	縦連	名詞	
たんほう	綻放	名詞	
だいあもんどだすと	Diamond Dust	名詞	
だいすけ	Daisuke	名詞	
だずりんだーりん	Dazzlin' Darlin	名詞	
だだだだだだだだだだ	打打打打打打打打打打	名詞	
だでぃーまるく	DADDY MULK	名詞	
だぶるいんぱくと	DOUBLE IMPACT	名詞	
だんえぼ	ダンエボ	名詞	
だんすえぼりゅーしょん	Dance Evolution	名詞	
だんすせんとらる	Dance Central	名詞	
だんすだんすれぼりゅーしょん	DanceDanceRevolution	名詞	
だんすまにあっくす	Dance Maniax	名詞	
だーく	DARK	名詞	
ちくせい	蓄勢	名詞	
ちくぱ	ちくパ	名詞	
ちくわぱふぇ	ちくわパフェだよ☆CKP	名詞	
ちゃれんじ	CHALLENGE	名詞	
ちゃーじのーと	チャージノート	名詞	
ちょうちゃれ	超チャレ	名詞	
つきかげさすらい	月影SASURAI	名詞	
つぎどか	つぎドカ	名詞	
てくにか	TECHNIKA	名詞	
てくのうち	DJ TECHNORCH	名詞	
てくのうち	TECHNORCH	名詞	
てら	TЁЯRA	名詞	
てんかいちおとげさい	天下一音ゲ祭	名詞	
てんごく	.59	名詞	
てんごくみゅーじっく	天国ミュージック	名詞	
てんじょうてんげ	X↑X↓	名詞	
てんてい	天庭	名詞	
てんびりおん	10,000,000,000	名詞	
てんようのまい	天妖ノ舞	名詞	
でぃあぼろ	DIAVOLO	名詞	
でぃすとーてっど	DistorteD	名詞	
でぃめんしょんず	DIMENSIONS	名詞	
でぃーば	DIVA	名詞	
でぃーも	Deemo	名詞	
でいどりーむ	DAY DREAM	名詞	
でいりーらんちすぺしゃる	Daily Lunch Special	名詞	
ですろう	Des-ROW	名詞	
でっどぼをるでほーむらん	デッドボヲルdeホームラン	名詞	
でびるふぃっしゅだんぷりんぐ	Devil Fish Dumpling	名詞	
でぶすてっぷ	DEBSTEP!	名詞	
でゅーとぅもろー	DUE TOMORROW	名詞	
でるたまっくす	ΔMAX	名詞	
でんじん、あかつきにたおれる	電人、暁に斃れる。	名詞	
といさいだーむら	トイサイダー村	名詞	
といずまーち	Toy'sMarch	名詞	
とぅえんてぃーのーべんばー	20,november	名詞	
とぅるあーれ	Truare!	名詞	
とぅるーぶるー	True Blue	名詞	
とぅーるはんまー	Thor's Hammer	名詞	
ときわゆう	常盤ゆう	名詞	
としやしき	1048式	名詞	
とっと	DJ TOTTO	名詞	
とっと	TOTTO	名詞	
とむはっく	Tom-H@ck	名詞	
ともすけ	TOMOSUKE	名詞	
とらいぶーすと	Tri-Boost	名詞	
とらいぶーすと	トライブースト	名詞	
とらぶ	トラブ	名詞	
とらん	トラン	名詞	
とりかごのほうおう	トリカゴノ鳳凰	名詞	
とりころ	tricoro	名詞	
とりる	トリル	名詞	
どかどか	dkdk	名詞	
どきょうきょうだい	度胸兄弟	名詞	
どらごんきらー	DRAGON KILLER	名詞	
どらむまにあ	DrumMania	名詞	
どるちぇ	DOLCE.	名詞	
どんきーこんが	ドンキーコンガ	名詞	
ないとめあ	NIGHTMARE	名詞	
ないん	IX	名詞	
ないんてぃーんのーべんばー	19,November	名詞	
なおき	NAOKI	名詞	
なぎさのこあくまらゔりぃーれいでぃお	†渚の小悪魔ラヴリィ〜レイディオ†	名詞	
なぐれお	dj nagureo	名詞	
なぐれお	nagureo	名詞	
にこにこさんふらわーきっす	魚氷に上り 耀よひて	名詞	
にじこん	虹コン	名詞	
にじゅういちのまえ	廿	名詞	
にじゅうよんぶ	24分	名詞	
にっと	knit	名詞	
にてら	IIDX	名詞	
にてら	弐寺	名詞	
ねいきっどぐろう	Naked Glow	名詞	
ねこまた	猫叉	名詞	
ねこまたますたー	猫叉Master	名詞	
ねころじー	NECOLOGY	名詞	
のい	neu	名詞	
はいえな	HYENA	名詞	
はいすぴ	ハイスピ	名詞	
はえれてぃくす	HAERETICUS	名詞	
はこにわのせかい	箱庭の世界	名詞	
はざーど	HAZARD	名詞	
はちぶ	8分	名詞	
はちやそば	888	名詞	
はにーはーとびーと	Honey Heartbeat	名詞	
はりゅう	春竜	名詞	
はろぽぷ	ハロポプ	名詞	
はんさむじぇっと	Handsome JET	名詞	
はーもにあ	Harmonia	名詞	
ばっど	BAD	名詞	
ばとる	BATTLE	名詞	
ばんぶら	バンブラ	名詞	
ばんぶーそーどがーる	バンブーソード・ガール	名詞	
ぱぁーのぅ	ﾊﾟｧｰﾉｩ	名詞	
ぱかぱかぱっしょん	パカパカパッション	名詞	
ぱせり	PASELI	名詞	
ぱらさば	パラ鯖	名詞	
ぱらのいあ	PARANOiA	名詞	
ぱらぱらぱらだいす	ParaParaParadise	名詞	
ぱんぷ	Pump It Up	名詞	
ぱーふぇくと	PERFECT	名詞	
ぱーぷるろーずふゅーじょん	Purple Rose Fusion	名詞	
ひいらぎりお	柊木りお	名詞	
ひっぷろっく	火風陸空	名詞	
ひどぅん	HIDDEN	名詞	
ひなたび	日向美	名詞	
ひなびた	ひなビタ	名詞	
ひふみ	緋浮美	名詞	
ひまわりぱんち	ひまわり*パンチ	名詞	
ひゃくびょう	The Least 100sec	名詞	
びそふらん	微ソフラン	名詞	
びびっとすとりーむ	ビビットストリーム	名詞	
びびっど	VIVID	名詞	
びーすと	BEAST	名詞	
びーすとはっかー	BEASTHACKER	名詞	
びーとぎゃざー	beat gather	名詞	
びーとすとりーむ	BeatStream	名詞	
びーとまにあ	beatmania	名詞	
びーなす	VENUS	名詞	
びーまに	BEMANI	名詞	
びーまにがくえん	BEMANI学園	名詞	
ぴらいと	P*Light	名詞	
ふぁしねーしょんまっくす	Fascination MAXX	名詞	
ふぁんとむらいだー	Phantom Rider	名詞	
ふぃーばー	FEVER	名詞	
ふううんしし	風雲志士	名詞	
ふぇーい	ﾌｪｰｲ	名詞	
ふぉーあるとらぷれいやーず	For UltraPlayers	名詞	
ふかせ	PHQUASE	名詞	
ふらっと	FLAT	名詞	
ふらわー	FLOWER	名詞	
ふるかわもとあき	古川もとあき	名詞	
ふること	序	名詞	
ふるこん	フルコン	名詞	
ふるふぃる	fulfill	名詞	
ふろあいんふぇくしょん	FLOOR INFECTION	名詞	
ぶつりょう	物量	名詞	
ぶらっきー	BlackY	名詞	
ぶらっくろーずあぱする	Black Rose Apostle	名詞	
ぶるーろーずれいん	Blue Rose Ruin	名詞	
ぶれーき	BRAKE	名詞	
ぶーすと	BOOST	名詞	
ぷあー	POOR	名詞	
ぷらな	PRANA	名詞	
ぷらむ	Plum	名詞	
ぷりむ	Prim	名詞	
ぷれーやーぼーど	プレーヤーボード	名詞	
ぷろっぷ	prop	名詞	
ぷろばろ	Übertreffen	名詞	
へんびょうし	変拍子	名詞	
べあがーでん	ベアガーデン	名詞	
べあもどき	ベアモドキ	名詞	
べが	VEGA	名詞	
べほゆ	BeForU	名詞	
ぺるでぃとぅすぱらでぃすす	perditus†paradisus	名詞	
ぺんでゅある	PENDUAL	名詞	
ほうおうてんぶむげんくずれ	鳳凰天舞無限崩れ	名詞	
ほうかごすとらいど	放課後ストライド	名詞	
ほうじょうやよい	豊穣弥生	名詞	
ほうりんぐ	Howling	名詞	
ほしのかなこ	星野奏子	名詞	
ほわいとろーずいんさにてぃー	White Rose Insanity	名詞	
ぽぜっしょん	POSSESSION	名詞	
ぽっぷん	pop'n	名詞	
ぽっぷんみゅーじっく	pop'n music	名詞	
ぽぷとも	ポプとも	名詞	
ぽりしーぶれいく	POLICY BREAK	名詞	
ぽん	PON	名詞	
まいまい	maimai	名詞	
まいまいまー	マイマイマー	名詞	
まえだなおき	前田尚紀	名詞	
まぐね	MAGne	名詞	
ますからーだ	MASCARADA	名詞	
まや	MAYA	名詞	
まりか	まり花	名詞	
まんぼあごーごー	MAMBO A GO GO	名詞	
まーまーついんず	murmur twins	名詞	
まーめいどがーる	Mermaid girl	名詞	
みでぃあむ	MEDIUM	名詞	
みゅーじっくがんがん	ミュージックガンガン	名詞	
みらいだがっき	ミライダガッキ	名詞	
みらー	MIRROR	名詞	
みんとてぃあーず	mint tears	名詞	
むげんのそら	夢幻の蒼空	名詞	
むつひこいずみ	Mutsuhiko Izumi	名詞	
むらいせいや	村井聖夜	名詞	
むりさら	無理皿	名詞	
むーんちゃいるど	moon_child	名詞	
めうめう	芽兎めう	名詞	
めぎつね	メギツネ	名詞	
めためたひまわりぱんち	めた・メタ?ひまわり*パンチ	名詞	
めめんともり	memento mori -intro-	名詞	
めんです	MENDES	名詞	
もいもい	moimoi	名詞	
もうそうがくえんいのこいぐみ	妄想学園ino-koi組	名詞	
もんきーびじねす	Monkey Business	名詞	
やきゅうのことがよくわかる	野球の遊び方 そしてその歴史 ～決定版～	名詞	
やまがたまりか	山形まり花	名詞	
ゆうげんのらん	幽玄ノ乱	名詞	
ゆうづつのすすきのときゆ	夕星の芒野と消ゆ	名詞	
ゆえい	Yuei	名詞	
ゆにぞん	UNISON	名詞	
ゆびおし	指押し	名詞	
ゆびーと	jubeat	名詞	
よざくらしゃにくさい	夜桜謝肉祭	名詞	
よざくらぶれいだあず	夜櫻ブレヰダアズ	名詞	
よしたか	DJ YOSHITAKA	名詞	
よしたか	YOSHITAKA	名詞	
よろろ	ﾖﾛﾛ	名詞	
よんじゅうはちぶ	48分	名詞	
らいおっとおぶからー	Riot of Color	名詞	
らいと	LIGHT	名詞	
らいむらいと	limelight	名詞	
らくがきすと	ラクガキスト	名詞	
らぶきゃんせーぶゆー	LUV CAN SAVE U	名詞	
ららばいあいしゅう	ララバイ哀愁	名詞	
らんだ	乱打	名詞	
らんだむ	RANDOM	名詞	
らんらんまらそん	RUNRUNマラソン	名詞	
りお	璃音	名詞	
りかーしぶふぁんくしょん	リカーシブ・ファンクション	名詞	
りさりしあ	Lisa-RICCIA	名詞	
りすきー	RISKY	名詞	
りせつ	理接	名詞	
りぞーとあんせむ	Resort Anthem	名詞	
りふれくびーと	REFLEC BEAT	名詞	
りぷるず	ripples	名詞	
りゅう	Ryu☆	名詞	
りょうげんのまい	燎原ノ舞	名詞	
りんくる	Lincle	名詞	
りんくるりんく	Lincle Link	名詞	
りんとしてさくはなのごとく	凛として咲く花の如く	名詞	
りんはな	凛花	名詞	
れいんぼー	RAINBOW	名詞	
れっどありす	REDALiCE	名詞	
れっどぐーす	Red Goose	名詞	
れっどぞーん	RED ZONE	名詞	
れっどろーるえばんげる	Red Rose Evangel	名詞	
れぼりゅーしょなりーあでぃくと	REVOLUTIONARY ADDICT	名詞	
れぼりゅーしょん	RЁVOLUTIΦN	名詞	
れんこ	連コ	名詞	
れんこいん	連コイン	名詞	
れんせんりょうらん	恋閃繚乱	名詞	
ろけて	ロケテ	名詞	
ろっくすみす	Rocksmith	名詞	
ろっくとぅいんふぃにてぃ	Rock to Infinity	名詞	
ろってるたーみねーしょん	Rotter Tarmination	名詞	
ろんぐ	LONG	名詞	
わだつみ	海神	名詞	
わっく	wac	名詞	
わんぎり	1切り	名詞	
わんもあ	ワンモア	名詞	
ゔぁねっさ	VANESSA	名詞	
ゔぁらんが	Valanga	名詞	
ゔぁりすねりあ	VALLIS-NERIA	名詞	
ゔぁーみりおん	Vermilion	名詞	
ゔぁーみりおん	Vermillion	名詞	
ゔぉいど	VOIDDD	名詞	
ひなたびびたーすいーつ	日向美ビタースイーツ	名詞	
しんくろにか	シンクロニカ	名詞	
ちゅうにずむ	チュウニズム	名詞	
