あおば	青葉	名詞	青葉型重巡洋艦一番艦
あおばがた	青葉型	名詞	重巡洋艦の艦型
あかぎ	赤城	名詞	航空母艦
あかつき	暁	名詞	暁型駆逐艦一番艦
あかつきがた	暁型	名詞	駆逐艦の艦型、特III型
あがの	阿賀野	名詞	阿賀野型軽巡洋艦一番艦
あがのがた	阿賀野型	名詞	軽巡洋艦の艦型
あきかぜ	秋風	名詞	峯風型駆逐艦九番艦
あきぐも	秋雲	名詞	陽炎型駆逐艦十九番艦
あきしも	秋霜	名詞	夕雲型駆逐艦十八番艦
あきづき	秋月	名詞	秋月型駆逐艦一番艦
あきづきがた	秋月型	名詞	駆逐艦の艦型
あけぼの	曙	名詞	綾波型駆逐艦八番艦
あさかぜ	朝風	名詞	神風型駆逐艦二番艦
あさぎり	朝霧	名詞	綾波型駆逐艦三番艦
あさぐも	朝雲	名詞	朝潮型駆逐艦五番艦
あさしお	朝潮	名詞	朝潮型駆逐艦一番艦
あさしおがた	朝潮型	名詞	駆逐艦の艦型
あさしも	朝霜	名詞	夕雲型駆逐艦十四番艦
あさなぎ	朝凪	名詞	神風型駆逐艦八番艦
あしがら	足柄	名詞	妙高型重巡洋艦三番艦
あそ	阿蘇	名詞	雲龍型航空母艦五番艦（未成）
あたご	愛宕	名詞	高雄型重巡洋艦二番艦
あぶくま	阿武隈	名詞	長良型軽巡洋艦六番艦
あまぎ	天城	名詞	1:雲龍型航空母艦二番艦
あまぎり	天霧	名詞	綾波型駆逐艦五番艦
あまつかぜ	天津風	名詞	陽炎型駆逐艦九番艦
あやなみ	綾波	名詞	綾波型駆逐艦一番艦
あやなみがた	綾波型	名詞	駆逐艦の艦型、特II型とも
あらし	嵐	名詞	陽炎型駆逐艦十六番艦
あらしお	荒潮	名詞	朝潮型駆逐艦四番艦
あられ	霰	名詞	朝潮型駆逐艦十番艦
ありあけ	有明	名詞	初春型駆逐艦五番艦
いかずち	雷	名詞	暁型駆逐艦三番艦
いかづち	雷	名詞	暁型駆逐艦三番艦
いこま	生駒	名詞	雲龍型航空母艦六番艦（未成）
いごうせんすいかん	伊号潜水艦	名詞	一等潜水艦のこと
いすず	五十鈴	名詞	長良型軽巡洋艦二番艦
いせ	伊勢	名詞	伊勢型戦艦一番艦
いせがた	伊勢型	名詞	戦艦の艦型
いそかぜ	磯風	名詞	陽炎型駆逐艦十二番艦
いそなみ	磯波	名詞	吹雪型駆逐艦九番艦
いちさんしき	一三式	名詞	
いちにがた	一二型	名詞	
いちにこう	一二甲	名詞	
いちまるしき	一〇式	名詞	
いなずま	電	名詞	暁型駆逐艦四番艦
いなづま	電	名詞	暁型駆逐艦四番艦
いぶき	伊吹	名詞	航空母艦（未成）
い168	伊168	名詞	海大VI型a一番艦
い58	伊58	名詞	巡潜乙型改二 三番艦
うしお	潮	名詞	綾波型駆逐艦十番艦
うすぐも	薄雲	名詞	吹雪型駆逐艦七番艦
うづき	卯月	名詞	睦月型駆逐艦四番艦
うみかぜ	海風	名詞	白露型駆逐艦七番艦
うめ	梅	名詞	松型駆逐艦三番艦
うらかぜ	浦風	名詞	陽炎型駆逐艦十一番艦
うらなみ	浦波	名詞	吹雪型駆逐艦十番艦
うんよう	雲鷹	名詞	大鷹型航空母艦二番艦
うんりゅう	雲龍	名詞	雲龍型航空母艦一番艦
うんりゅうがた	雲龍型	名詞	航空母艦の艦型
えのき	榎	名詞	橘型駆逐艦十二番艦
おいて	追風	名詞	神風型駆逐艦六番艦
おおい	大井	名詞	球磨型軽巡洋艦四番艦
おおいっち	大井っち	名詞	
おおしお	大潮	名詞	朝潮型駆逐艦二番艦
おおなみ	大波	名詞	夕雲型駆逐艦七番艦
おおよど	大淀	名詞	大淀型軽巡洋艦一番艦
おおよどがた	大淀型	名詞	軽巡洋艦の艦型
おきかぜ	沖風	名詞	峯風型駆逐艦三番艦
おきなみ	沖波	名詞	夕雲型駆逐艦十六番艦
おだけ	雄竹	名詞	橘型駆逐艦十三番艦
おぼろ	朧	名詞	綾波型駆逐艦七番艦
おやしお	親潮	名詞	陽炎型駆逐艦四番艦
かいいち	改一	接尾一般	
かいおおいちがた	海大I型	名詞	伊号第五一潜水艦の艦型、同型艦はない
かいおおがた	海大型	名詞	潜水艦の艦級、海軍式大型を意味する
かいおおごがた	海大V型	名詞	潜水艦の艦型、伊一六五型とも
かいおおさんがた	海大III型	名詞	伊一五三型及び伊一五六型
かいおおさんがたあ	海大III型a	名詞	潜水艦の艦型、伊一五三型とも
かいおおさんがたえー	海大III型a	名詞	潜水艦の艦型、伊一五三型とも
かいおおさんがたびー	海大III型b	名詞	潜水艦の艦型、伊一五六型とも
かいおおさんがたb	海大III型b	名詞	潜水艦の艦型、伊一五六型とも
かいおおなながた	海大VII型	名詞	潜水艦の艦型
かいおおにがた	海大II型	名詞	伊号第一五二潜水艦の艦型、同型艦はない
かいおおよんがた	海大IV型	名詞	潜水艦の艦型、伊一六二型とも
かいおおろくがた	海大VI型	名詞	伊一六八型及び伊一七四型
かいおおろくがたあ	海大VI型a	名詞	潜水艦の艦型、伊一六八型とも
かいおおろくがたえー	海大VI型a	名詞	潜水艦の艦型、伊一六八型とも
かいおおろくがたびー	海大VI型b	名詞	潜水艦の艦型、伊一七四型とも
かいおおろくがたb	海大VI型b	名詞	潜水艦の艦型、伊一七四型とも
かいおお1がた	海大I型	名詞	伊号第五一潜水艦の艦型、同型艦はない
かいおお2がた	海大II型	名詞	伊号第一五二型潜水艦の艦型、同型艦はない
かいおお3がた	海大III型	名詞	伊一五三型及び伊一五六型
かいおお3がたあ	海大III型a	名詞	潜水艦の艦型、伊一五三型とも
かいおお3がたえー	海大III型a	名詞	潜水艦の艦型、伊一五三型とも
かいおお3がたびー	海大III型b	名詞	潜水艦の艦型、伊一五六型とも
かいおお3がたb	海大III型b	名詞	潜水艦の艦型、伊一五六型とも
かいおお4がた	海大IV型	名詞	潜水艦の艦型、伊一六二型とも
かいおお5がた	海大V型	名詞	潜水艦の艦型、伊一六五型とも
かいおお6がた	海大VI型	名詞	伊一六八型及び伊一七四型
かいおお6がたあ	海大VI型a	名詞	潜水艦の艦型、伊一六八型とも
かいおお6がたえー	海大VI型a	名詞	潜水艦の艦型、伊一六八型とも
かいおお6がたびー	海大VI型b	名詞	潜水艦の艦型、伊一七四型とも
かいおお6がたb	海大VI型b	名詞	潜水艦の艦型、伊一七四型とも
かいおお7がた	海大VII型	名詞	潜水艦の艦型
かいだいいちがた	海大I型	名詞	伊号第五一潜水艦の艦型、同型艦はない
かいだいがた	海大型	名詞	潜水艦の艦級、海軍式大型を意味する
かいだいごがた	海大V型	名詞	潜水艦の艦型、伊一六五型とも
かいだいさんがた	海大III型	名詞	伊一五三型及び伊一五六型
かいだいさんがたあ	海大III型a	名詞	潜水艦の艦型、伊一五三型とも
かいだいさんがたえー	海大III型a	名詞	潜水艦の艦型、伊一五三型とも
かいだいさんがたびー	海大III型b	名詞	潜水艦の艦型、伊一五六型とも
かいだいさんがたb	海大III型b	名詞	潜水艦の艦型、伊一五六型とも
かいだいなながた	海大VII型	名詞	潜水艦の艦型
かいだいにがた	海大II型	名詞	伊号第一五二潜水艦の艦型、同型艦はない
かいだいよんがた	海大IV型	名詞	潜水艦の艦型、伊一六二型とも
かいだいろくがた	海大VI型	名詞	伊一六八型及び伊一七四型
かいだいろくがたあ	海大VI型a	名詞	潜水艦の艦型、伊一六八型とも
かいだいろくがたえー	海大VI型a	名詞	潜水艦の艦型、伊一六八型とも
かいだいろくがたびー	海大VI型b	名詞	潜水艦の艦型、伊一七四型とも
かいだいろくがたb	海大VI型b	名詞	潜水艦の艦型、伊一七四型とも
かいだい1がた	海大I型	名詞	伊号第五一潜水艦の艦型、同型艦はない
かいだい2がた	海大II型	名詞	伊号第一五二型潜水艦の艦型、同型艦はない
かいだい3がた	海大III型	名詞	伊一五三型及び伊一五六型
かいだい3がたあ	海大III型a	名詞	潜水艦の艦型、伊一五三型とも
かいだい3がたえー	海大III型a	名詞	潜水艦の艦型、伊一五三型とも
かいだい3がたびー	海大III型b	名詞	潜水艦の艦型、伊一五六型とも
かいだい3がたb	海大III型b	名詞	潜水艦の艦型、伊一五六型とも
かいだい4がた	海大IV型	名詞	潜水艦の艦型、伊一六二型とも
かいだい5がた	海大V型	名詞	潜水艦の艦型、伊一六五型とも
かいだい6がた	海大VI型	名詞	伊一六八型及び伊一七四型
かいだい6がたあ	海大VI型a	名詞	潜水艦の艦型、伊一六八型とも
かいだい6がたえー	海大VI型a	名詞	潜水艦の艦型、伊一六八型とも
かいだい6がたびー	海大VI型b	名詞	潜水艦の艦型、伊一七四型とも
かいだい6がたb	海大VI型b	名詞	潜水艦の艦型、伊一七四型とも
かいだい7がた	海大VII型	名詞	潜水艦の艦型
かいに	改二	接尾一般	
かいよう	海鷹	名詞	航空母艦
かい1	改一	接頭語	
かい2	改二	接尾一般	
かえで	楓	名詞	松型駆逐艦十七番艦
かが	加賀	名詞	航空母艦
かき	柿	名詞	橘型駆逐艦二番艦
かげろう	陽炎	名詞	陽炎型駆逐艦一番艦
かげろうがた	陽炎型	名詞	駆逐艦の艦型
かこ	加古	名詞	古鷹型重巡洋艦二番艦
かさぎ	笠置	名詞	雲龍型航空母艦四番艦（未成）
かざくも	風雲	名詞	夕雲型駆逐艦三番艦
かし	樫	名詞	松型駆逐艦十番艦
かすみ	霞	名詞	朝潮型駆逐艦九番艦
かつらぎ	葛城	名詞	雲龍型航空母艦三番艦
かば	樺	名詞	橘型駆逐艦三番艦
かみかぜ	神風	名詞	神風型駆逐艦一番艦
かみかぜがた	神風型	名詞	駆逐艦の艦型
かもい	神威	名詞	神威型水上機母艦一番艦
かや	榧	名詞	松型駆逐艦十一番艦
かわかぜ	江風	名詞	白露型駆逐艦九番艦
かんがた	艦型	名詞	
かんきゅう	艦級	名詞	
かんこう	艦攻	名詞	艦上攻撃機
かんこれ	艦これ	名詞	艦隊これくしょん
かんせん	艦船	名詞	船全般を指す語
かんせん	艦戦	名詞	艦上戦闘機
かんたいこれくしょん	艦隊これくしょん	名詞	
かんてい	艦艇	名詞	戦闘用の船の総称
かんてい	艦偵	名詞	艦上偵察機
かんばく	艦爆	名詞	艦上爆撃機
かんほんしき	艦本式	名詞	
かんほんしきかん	艦本式缶	名詞	
かんぽんしき	艦本式	名詞	
かんぽんしきかん	艦本式缶	名詞	
かんむす	艦娘	名詞	
かんめい	艦名	名詞	
きくづき	菊月	名詞	睦月型駆逐艦九番艦
きさらぎ	如月	名詞	睦月型駆逐艦二番艦
きしなみ	岸波	名詞	夕雲型駆逐艦十五番艦
きそ	木曾	名詞	球磨型軽巡洋艦五番艦
きたかみ	北上	名詞	球磨型軽巡洋艦三番艦
きたがみ	北上	名詞	球磨型軽巡洋艦三番艦
きぬ	鬼怒	名詞	長良型軽巡洋艦五番艦
きぬがさ	衣笠	名詞	青葉型重巡洋艦二番艦
きゅういちしき	九一式	名詞	
きゅういちしきてっこうだん	九一式徹甲弾	名詞	対艦強化弾
きゅうきゅうしき	九九式	名詞	
きゅうごしき	九五式	名詞	
きゅうさんしき	九三式	名詞	
きゅうななしき	九七式	名詞	
きゅうにしき	九二式	名詞	
きゅうはちしき	九八式	名詞	
きゅうまるしき	九〇式	名詞	
きゅうよんしき	九四式	名詞	
きゅうろくしき	九六式	名詞	
きよしも	清霜	名詞	夕雲型駆逐艦十九番艦
きよなみ	清波	名詞	夕雲型駆逐艦八番艦
きり	桐	名詞	松型駆逐艦六番艦
きりしま	霧島	名詞	金剛型巡洋戦艦一番艦
くすのき	楠	名詞	橘型駆逐艦七番艦
くちくたい	駆逐隊	名詞	
くま	球磨	名詞	球磨型軽巡洋艦一番艦
くまがた	球磨型	名詞	軽巡洋艦の艦型
くまの	熊野	名詞	最上型重巡洋艦四番艦
くらま	鞍馬	名詞	雲龍型航空母艦七番艦（未成）
くれちん	呉鎮	名詞	
くろしお	黒潮	名詞	陽炎型駆逐艦三番艦
くわ	桑	名詞	松型駆逐艦五番艦
けいくう	軽空	名詞	軽空母
けいくうぼ	軽空母	名詞	
けいじゅん	軽巡	名詞	軽巡洋艦
けいぼ	軽母	名詞	軽空母
けやき	欅	名詞	松型駆逐艦十八番艦
こうかくほう	高角砲	名詞	
こうくうじゅんようかん	航空巡洋艦	名詞	
こうじゅん	航巡	名詞	航空巡洋艦
こうせん	航戦	名詞	航空戦艦
こうひょうてき	甲標的	名詞	特殊潜航艇
こうひょうてきぼかん	甲標的母艦	名詞	
こうりゅう	蛟龍	名詞	特殊潜航艇
こうりゅう	蛟竜	名詞	特殊潜航艇
こんごう	金剛	名詞	金剛型巡洋戦艦一番艦
こんごうがた	金剛型	名詞	戦艦の艦型
ごちん	呉鎮	名詞	
さいうん	彩雲	名詞	艦上偵察機
さかわ	酒匂	名詞	阿賀野型軽巡洋艦四番艦
さぎり	狭霧	名詞	綾波型駆逐艦六番艦
さくてき	索敵	名詞	
さくら	櫻	名詞	松型駆逐艦十三番艦
さざなみ	漣	名詞	綾波型駆逐艦九番艦
させちん	佐鎮	名詞	
さちん	佐鎮	名詞	
さつき	皐月	名詞	睦月型駆逐艦五番艦
さみだれ	五月雨	名詞	白露型駆逐艦六番艦
さわかぜ	澤風	名詞	峯風型駆逐艦二番艦
さんごうほう	20.3cm(3号)連装砲	名詞	[重巡主砲]だが何故か軽巡でも装備可能
さんごうれんそうほう	(3号)連装砲	名詞	
さんしきだん	三式弾	名詞	対空強化弾
さんれんそうほう	三連装砲	名詞	
しい	椎	名詞	橘型駆逐艦十一番艦
しおかぜ	汐風	名詞	峯風型駆逐艦八番艦
しきなみ	敷波	名詞	綾波型駆逐艦二番艦
しぐれ	時雨	名詞	白露型駆逐艦二番艦
しせいせいらん	試製晴嵐	名詞	水上攻撃機
しでん	紫電	名詞	局地戦闘機
しでんかい	紫電改	名詞	局地戦闘機
しでんかいに	紫電改二	名詞	艦上戦闘機
しなの	信濃	名詞	航空母艦
しののめ	東雲	名詞	吹雪型駆逐艦六番艦
しまかぜ	島風	名詞	1:島風型駆逐艦一番艦
しまかぜがた	島風型	名詞	駆逐艦の艦型
しもつき	霜月	名詞	秋月型駆逐艦七番艦
しょうかく	翔鶴	名詞	翔鶴型航空母艦一番艦
しょうほう	祥鳳	名詞	祥鳳型航空母艦一番艦
しらくも	白雲	名詞	吹雪型駆逐艦八番艦
しらつゆ	白露	名詞	白露型駆逐艦一番艦
しらつゆがた	白露型	名詞	駆逐艦の艦型
しらぬい	不知火	名詞	陽炎型駆逐艦二番艦
しらゆき	白雪	名詞	吹雪型駆逐艦二番艦
しんかいおおがた	新海大型	名詞	潜水艦の艦型
しんかいせいかん	深海棲艦	名詞	艦娘に襲い掛かる謎の艦隊
しんかいだいがた	新海大型	名詞	潜水艦の艦型
しんでん	震電	名詞	局地戦闘機
しんでんかい	震電改	名詞	艦上戦闘機
しんよう	神鷹	名詞	航空母艦
じゅうじゅん	重巡	名詞	重巡洋艦
じゅうらいそうじゅんようかん	重雷装巡洋艦	名詞	
じゅんせん	巡潜	名詞	巡洋潜水艦
じゅんせんいちがた	巡潜I型	名詞	潜水艦の艦型、伊一型とも
じゅんせんおつがた	巡潜乙型	名詞	潜水艦の艦型、伊十五型とも
じゅんせんおつがたかいいち	巡潜乙型改一	名詞	潜水艦の艦型、伊四〇型とも
じゅんせんおつがたかいに	巡潜乙型改二	名詞	潜水艦の艦型、伊五四型とも
じゅんせんおつがたかい2	巡潜乙型改二	名詞	潜水艦の艦型、伊五四型とも
じゅんせんがた	巡潜型	名詞	潜水艦の艦級、巡潜は巡洋潜水艦の意
じゅんせんこうがた	巡潜甲型	名詞	潜水艦の艦型、伊九型とも
じゅんせんこうがたかいいち	巡潜甲型改一	名詞	伊号第十二潜水艦の艦型、同型艦はない
じゅんせんこうがたかいに	巡潜甲型改二	名詞	潜水艦の艦型、伊十三型とも
じゅんせんこうがたかい1	巡潜甲型改一	名詞	伊号第十二潜水艦の艦型、同型艦はない
じゅんせんこうがたかい2	巡潜甲型改二	名詞	潜水艦の艦型、伊十三型とも
じゅんせんさんがた	巡潜III型	名詞	潜水艦の艦級、伊七型とも
じゅんせんにがた	巡潜II型	名詞	伊号第六潜水艦の艦型、同型艦はなし
じゅんせんへいがた	巡潜丙型	名詞	潜水艦の艦型、伊一六型とも
じゅんせんへいがたかい	巡潜丙型改	名詞	潜水艦の艦型、伊五二型とも
じゅんせん1がた	巡潜I型	名詞	潜水艦の艦型、伊一型とも
じゅんせん2がた	巡潜II型	名詞	伊号第六潜水艦の艦型、同型艦はない
じゅんせん3がた	巡潜III型	名詞	潜水艦の艦型、伊七型とも
じゅんよう	隼鷹	名詞	飛鷹型航空母艦二番艦
じんつう	神通	名詞	川内型軽巡洋艦二番艦
すいじょうき	水上機	名詞	
すいじょうきぼかん	水上機母艦	名詞	
すいじょうていさつき	水上偵察機	名詞	
すいじょうばくげきき	水上爆撃機	名詞	
すいせい	彗星	名詞	艦上爆撃機
すいてい	水偵	名詞	水上偵察機
すいぼ	水母	名詞	くらげではない
すぎ	杉	名詞	松型駆逐艦七番艦
すずかぜ	涼風	名詞	白露型駆逐艦十番艦
すずかぜ	凉風	名詞	白露型駆逐艦十番艦
すずつき	涼月	名詞	秋月型駆逐艦三番艦
すずつき	凉月	名詞	秋月型駆逐艦三番艦
すずなみ	涼波	名詞	夕雲型駆逐艦十番艦
すずなみ	凉波	名詞	夕雲型駆逐艦十番艦
すずや	鈴谷	名詞	最上型重巡洋艦三番艦
すみれ	菫	名詞	橘型駆逐艦六番艦
ずいうん	瑞雲	名詞	急降下爆撃が可能になった多用途水上機
ずいかく	瑞鶴	名詞	翔鶴型航空母艦二番艦
ずいほう	瑞鳳	名詞	祥鳳型航空母艦二番艦
せいしゃ	斉射	名詞サ変	主砲を一斉に発射すること
せいらん	晴嵐	名詞	水上攻撃機
せんすいくうぼ	潜水空母	名詞	空母と名前にはあるが、航空戦艦や航空巡洋艦に近い艦種
せんだい	川内	名詞	川内型軽巡洋艦一番艦
せんだいがた	川内型	名詞	軽巡洋艦の艦型
せんぼ	潜母	名詞	潜水空母
ぜろかん	零観	名詞	零式水上観測機
そうりゅう	蒼龍	名詞	蒼龍型航空母艦一番艦
たいほう	大鳳	名詞	大鳳型航空母艦一番艦
たいよう	大鷹	名詞	大鷹型航空母艦一番艦
たかお	高雄	名詞	高雄型重巡洋艦一番艦
たかおがた	高雄型	名詞	重巡洋艦の艦型
たかなみ	高波	名詞	夕雲型駆逐艦六番艦
たけ	竹	名詞	松型駆逐艦二番艦
たちかぜ	太刀風	名詞	峯風型駆逐艦十一番艦
たちばな	橘	名詞	橘型駆逐艦一番艦
たちばながた	橘型	名詞	駆逐艦の艦型
たつた	龍田	名詞	天龍型軽巡洋艦二番艦
たにかぜ	谷風	名詞	陽炎型駆逐艦十四番艦
たま	多摩	名詞	球磨型軽巡洋艦二番艦
たまなみ	玉波	名詞	夕雲型駆逐艦九番艦
たんおう	単横	名詞	
たんおうじん	単横陣	名詞	
たんしんぎ	探信儀	名詞	
たんじゅう	単縦	名詞	
たんじゅうじん	単縦陣	名詞	
たんそう	単装	名詞	
たんそうほう	単装砲	名詞	
ちくま	筑摩	名詞	利根型重巡洋艦二番艦
ちとせ	千歳	名詞	千歳型水上機母艦一番艦
ちとせがた	千歳型	名詞	水上機母艦及び航空母艦の艦型
ちゅうよう	冲鷹	名詞	大鷹型航空母艦三番艦
ちょうかい	鳥海	名詞	高雄型重巡洋艦四番艦
ちょうどきゅう	超弩級	名詞形動	英戦艦ドレッドノートを超えていると言う意味
ちよだ	千代田	名詞	千歳型水上機母艦二番艦
つた	蔦	名詞	橘型駆逐艦四番艦
つばき	椿	名詞	松型駆逐艦十五番艦
ていけいじん	梯形陣	名詞	
てっこう	徹甲	名詞	
てっこうだん	徹甲弾	名詞	
てるづき	照月	名詞	秋月型駆逐艦二番艦
てんざん	天山	名詞	艦上攻撃機
てんりゅう	天龍	名詞	天龍型軽巡洋艦一番艦
てんりゅうがた	天龍型	名詞	軽巡洋艦の艦種
ときつかぜ	時津風	名詞	陽炎型駆逐艦十番艦
とくいちがた	特I型	名詞	駆逐艦の艦型、吹雪型とも
とくがた	特型	名詞	駆逐艦の艦型、特I～特IIIの総称
とくさんがた	特III型	名詞	駆逐艦の艦型、暁型とも
とくにがた	特II型	名詞	駆逐艦の艦型、綾波型とも
とね	利根	名詞	利根型重巡洋艦一番艦
とねがた	利根型	名詞	重巡洋艦の艦型
なか	那珂	名詞	川内型軽巡洋艦三番艦
ながつき	長月	名詞	睦月型駆逐艦八番艦
ながと	長門	名詞	長門型戦艦一番艦
ながとがた	長門型	名詞	戦艦の艦型
ながなみ	長波	名詞	夕雲型駆逐艦四番艦
ながら	長良	名詞	長良型軽巡洋艦一番艦
ながらがた	長良型	名詞	軽巡洋艦の艦型
なし	梨	名詞	橘型駆逐艦十番艦
なだかぜ	灘風	名詞	峯風型駆逐艦五番艦
なち	那智	名詞	妙高型重巡洋艦二番艦
なつぐも	夏雲	名詞	朝潮型駆逐艦七番艦
なつしお	夏潮	名詞	陽炎型駆逐艦六番艦
なつづき	夏月	名詞	冬月型駆逐艦四番艦
なとり	名取	名詞	長良型軽巡洋艦三番艦
なみかぜ	波風	名詞	峯風型駆逐艦十三番艦
なら	楢	名詞	松型駆逐艦十二番艦
にいづき	新月	名詞	秋月型駆逐艦五番艦
にっしん	日進	名詞	日進型水上機母艦一番艦
によど	仁淀	名詞	大淀型軽巡洋艦二番艦（未成）
にれ	楡	名詞	橘型駆逐艦九番艦
ぬまかぜ	沼風	名詞	峯風型駆逐艦十四番艦
ねこ	猫	動詞ラ行五段	通信エラーが発生した為、
ねのひ	子日	名詞	初春型駆逐艦二番艦
のかぜ	野風	名詞	峯風型駆逐艦十二番艦
のしろ	能代	名詞	阿賀野型軽巡洋艦二番艦
のわき	野分	名詞	陽炎型駆逐艦十五番艦
はかぜ	羽風	名詞	峯風型駆逐艦七番艦
はぎ	萩	名詞	橘型駆逐艦五番艦
はぎかぜ	萩風	名詞	陽炎型駆逐艦十七番艦
はぐろ	羽黒	名詞	妙高型重巡洋艦四番艦
はごうせんすいかん	波号潜水艦	名詞	三等潜水艦のこと
はたかぜ	旗風	名詞	神風型駆逐艦五番艦
はつうめ	初梅	名詞	橘型駆逐艦十四番艦
はつかぜ	初風	名詞	陽炎型駆逐艦七番艦
はつざくら	初櫻	名詞	橘型駆逐艦八番艦
はつしも	初霜	名詞	初春型駆逐艦四番艦
はつづき	初月	名詞	秋月型駆逐艦四番艦
はつはる	初春	名詞	初春型駆逐艦一番艦
はつはるがた	初春型	名詞	駆逐艦の艦型
はつゆき	初雪	名詞	吹雪型駆逐艦三番艦
はなづき	花月	名詞	満月型駆逐艦二番艦
はまかぜ	浜風	名詞	陽炎型駆逐艦十三番艦
はまなみ	浜波	名詞	夕雲型駆逐艦十三番艦
はまなみ	濱波	名詞	夕雲型駆逐艦十三番艦
はやしお	早潮	名詞	陽炎型駆逐艦五番艦
はやしも	早霜	名詞	夕雲型駆逐艦十七番艦
はやて	疾風	名詞	神風型駆逐艦七番艦
はやなみ	早波	名詞	夕雲型駆逐艦十二番艦
はるかぜ	春風	名詞	神風型駆逐艦三番艦
はるさめ	春雨	名詞	白露型駆逐艦五番艦
はるつき	春月	名詞	冬月型駆逐艦二番艦
はるな	榛名	名詞	金剛型巡洋戦艦三番艦
ばくらいとうしゃき	爆雷投射機	名詞	
ばつびょう	抜錨	名詞サ変	錨を上げること
ばんかん	番艦	助数詞	
ひえい	比叡	名詞	金剛型巡洋戦艦二番艦
ひしょかん	秘書艦	名詞	第一艦隊の旗艦娘のこと
ひだりげん	左舷	名詞	
ひのき	檜	名詞	松型駆逐艦十六番艦
ひびき	響	名詞	暁型駆逐艦二番艦
ひゅうが	日向	名詞	伊勢型戦艦二番艦
ひよう	飛鷹	名詞	飛鷹型航空母艦一番艦
ひりゅう	飛龍	名詞	飛龍型航空母艦一番艦
ふくじゅう	複縦	名詞	
ふくじゅうじん	複縦陣	名詞	
ふくほう	副砲	名詞	
ふじなみ	藤波	名詞	夕雲型駆逐艦十一番艦
ふそう	扶桑	名詞	扶桑型戦艦一番艦
ふそうがた	扶桑型	名詞	戦艦の艦型。
ふぶき	吹雪	名詞	吹雪型駆逐艦一番艦
ふぶきがた	吹雪型	名詞	駆逐艦の艦型、特I型
ふみづき	文月	名詞	睦月型駆逐艦七番艦
ふゆづき	冬月	名詞	冬月型駆逐艦一番艦
ふゆづきがた	冬月型	名詞	駆逐艦の艦型
ふるたか	古鷹	名詞	古鷹型重巡洋艦一番艦
ふるたかがた	古鷹型	名詞	重巡洋艦の艦型
ふんしんほう	噴進砲	名詞	
ほうしょう	鳳翔	名詞	鳳翔型航空母艦一番艦
ほうらいげき	砲雷撃	名詞	
まいかぜ	舞風	名詞	陽炎型駆逐艦十八番艦
まいちん	舞鎮	名詞	
まき	槇	名詞	松型駆逐艦八番艦
まきぐも	巻雲	名詞	夕雲型駆逐艦二番艦
まきなみ	巻波	名詞	夕雲型駆逐艦五番艦
まつ	松	名詞	松型駆逐艦一番艦
まつかぜ	松風	名詞	神風型駆逐艦四番艦
まつがた	松型	名詞	駆逐艦の艦型
まや	摩耶	名詞	高雄型重巡洋艦三番艦
みかづき	三日月	名詞	睦月型駆逐艦十番艦
みぎげん	右舷	名詞	
みくま	三隈	名詞	最上型重巡洋艦二番艦
みずほ	瑞穂	名詞	瑞穂型水上機母艦一番艦
みせい	未成	名詞	
みせいかん	未成艦	名詞	
みちしお	満潮	名詞	朝潮型駆逐艦三番艦
みちづき	満月	名詞	満月型駆逐艦一番艦（未成）
みちづきがた	満月型	名詞	駆逐艦の艦型
みなづき	水無月	名詞	睦月型駆逐艦六番艦
みねかぜ	峯風	名詞	峯風型駆逐艦一番艦
みねかぜかた	峯風型	名詞	駆逐艦の艦型
みねぐも	峯雲	名詞	朝潮型駆逐艦八番艦
みゆき	深雪	名詞	吹雪型駆逐艦四番艦
みょうこう	妙高	名詞	妙高型重巡洋艦一番艦
みょうこうがた	妙高型	名詞	重巡洋艦の艦型
むさし	武蔵	名詞	大和型戦艦二番艦
むつ	陸奥	名詞	長門型戦艦二番艦
むつき	睦月	名詞	睦月型駆逐艦一番艦
むつきがた	睦月型	名詞	駆逐艦の艦型
むらくも	叢雲	名詞	吹雪型駆逐艦五番艦
むらさめ	村雨	名詞	白露型駆逐艦三番艦
もがみ	最上	名詞	最上型重巡洋艦一番艦
もがみがた	最上型	名詞	重巡洋艦の艦型
もちづき	望月	名詞	睦月型駆逐艦十一番艦
もみ	樅	名詞	松型駆逐艦九番艦
もも	桃	名詞	松型駆逐艦四番艦
やかぜ	矢風	名詞	峯風型駆逐艦六番艦
やなぎ	柳	名詞	松型駆逐艦十四番艦
やはぎ	矢矧	名詞	阿賀野型軽巡洋艦三番艦
やまかぜ	山風	名詞	白露型駆逐艦八番艦
やまぐも	山雲	名詞	朝潮型駆逐艦六番艦
やましろ	山城	名詞	扶桑型戦艦二番艦
やまと	大和	名詞	大和型戦艦一番艦
やまとがた	大和型	名詞	戦艦の艦型
やよい	弥生	名詞	睦月型駆逐艦三番艦
ゆうかぜ	夕風	名詞	峯風型駆逐艦十番艦
ゆうぎり	夕霧	名詞	綾波型駆逐艦四番艦
ゆうぐも	夕雲	名詞	夕雲型駆逐艦一番艦
ゆうぐもがた	夕雲型	名詞	駆逐艦の艦型
ゆうぐれ	夕暮	名詞	初春型駆逐艦六番艦
ゆうだち	夕立	名詞	白露型駆逐艦四番艦
ゆうづき	夕月	名詞	睦月型駆逐艦十二番艦
ゆうなぎ	夕凪	名詞	神風型駆逐艦九番艦
ゆうばり	夕張	名詞	夕張型軽巡洋艦一番艦
ゆきかぜ	雪風	名詞	陽炎型駆逐艦八番艦
ゆら	由良	名詞	長良型軽巡洋艦四番艦
よいづき	宵月	名詞	冬月型駆逐艦三番艦
よこちん	横鎮	名詞	
らいげきせん	雷撃戦	名詞	
らいじゅん	雷巡	名詞	重雷装巡洋艦
らいそう	雷装	名詞	
りゅうじょう	龍驤	名詞	龍驤型航空母艦一番艦
りゅうせい	流星	名詞	艦上攻撃機
りんけいじん	輪形陣	名詞	
れいかん	零観	名詞	零式水上観測機
れいしき	零式	名詞	
れいしきかんせんろくにがた	零式艦戦62型(爆戦)	名詞	艦これでの区分は艦上爆撃機
れいすいてい	零水偵	名詞	零式水上偵察機の略称
れいせんろくにがた	零戦六二型	名詞	戦闘爆撃機
れんそう	連装	助数詞	
れんそうさんそぎょらい	連装(酸素)魚雷	助数詞	
れんそうほう	連装砲	名詞	
ろごうせんすいかん	呂号潜水艦	名詞	二等潜水艦のこと
わかつき	若月	名詞	秋月型駆逐艦六番艦
わかば	若葉	名詞	初春型駆逐艦三番艦
ゔぇーるぬい	Верный	名詞	ソ連へと引き渡された暁型駆逐艦二番艦｢響｣より改称
でかぶりすと	Декабрист	名詞	練習艦となった｢Верный｣
12がた	一二型	名詞	
12こう	一二甲	名詞	
15.5cmさんれんそうふくほう	15.5cm三連装砲(副砲)	名詞	
15.5cmさんれんそうほうふくほう	15.5cm三連装砲(副砲)	名詞	
3ごうほう	20.3cm(3号)連装砲	名詞	[重巡主砲]だが何故か軽巡でも装備可能
