かんたいこれくしょん	艦隊これくしょん	固有名詞	
かんこれ	艦これ	固有名詞	
かむらんはんとう	カムラン半島	地名	
ばしーとう	バシー島	地名	
おりょーるかい	オリョール海	地名	
もーれいかい	モーレイ海	地名	
きすとう	キス島	地名	
あるふぉんしーの	アルフォンシーノ	地名	
じゃむとう	ジャム島	地名	
かれーよう	カレー洋	地名	
りらんかとう	リランカ島	地名	
かすがだま	カスガダマ	地名	
たんじゅうじん	単縦陣	名詞	
ふくじゅうじん	複縦陣	名詞	
りんけいじん	輪形陣	名詞	
ていけいじん	梯形陣	名詞	
たんおうじん	単横陣	名詞	
えらーむすめ	エラー娘	名詞	
ずかんむすめ	図鑑娘	名詞	
めんてむすめ	メンテ娘	名詞	
あくせすむすめ	アクセス娘	名詞	
ねこつるし	猫吊るし	固有名詞	
ねこどげざ	猫土下座	固有名詞	
よこちん	横鎮	固有名詞	
くれちん	呉鎮	固有名詞	
させちん	佐世鎮	固有名詞	
まいちん	舞鎮	固有名詞	
ばつびょう	抜猫	名詞サ変	
きゅうかんび	休艦日	名詞	
らいそう	雷装	名詞	
かいに	改二	名詞	
かい	改	名詞	
かんむす	艦娘	名詞	
