Amazinghappyman	Amazing Happy Man!!!!!	名詞	
Antiworld	Anti world	名詞	
Butterflyeffect	Butterfly Effect	名詞	
City	CITY	名詞	
Cocoon	Cocoon	名詞	
Crazyeasymode	Crazy Easy Mode	名詞	
Curtainraise	Curtain raise	名詞	
Dearly	Dearly	名詞	
Donutringworld	Donut Ring World	名詞	
Eternalplaceだいいちがくしょう	Eternal Place 第一楽章	名詞	
Eternalplaceだいさんがくしょう	Eternal Place 第三楽章	名詞	
Eternalplaceだいにがくしょう	Eternal Place 第二楽章	名詞	
Futureline	FUTURE LINE	名詞	
Goodshepherd	Good Shepherd	名詞	
Happiness	Happiness	名詞	
Iwannabeastar	I wanna be a STAR	名詞	
Iwill	I will	名詞	
Lilac	Lilac	名詞	
Lotus	Lotus	名詞	
Me	ME	名詞	
Merlottears	Merlot Tears	名詞	
Mirrormirror	Mirror Mirror	名詞	
Morningglow	Morning glow	名詞	
Myprologue	My Prologue	名詞	
Nolifecode	NO LIFE CODE	名詞	
Ordinarylove	ORDINARY LOVE	名詞	
Outofblue	OUT OF BLUE	名詞	
Poisongirl	Poison Girl	名詞	
Remained	REMAINED	名詞	
Sosweet	So Sweet	名詞	
Storytelling	Storytelling	名詞	
Strawberryegoist	Strawberry Egoist	名詞	
Thestartofphoenix	The Start of Phoenix	名詞	
Tiered	Tiered	名詞	
Wonderland	Wonderland!!	名詞	
Yourwaymyway	Your Way My Way	名詞	
Yのひげき	Yの悲劇	名詞	
あいうぃる	I will	名詞	
あいしてるはなんぐらむ	アイシテルは♡グラム？	名詞	
あいなんて	アイナンテ	名詞	
あいわなびーあすたー	I wanna be a STAR	名詞	
あうとおぶぶるー	OUT OF BLUE	名詞	
あずらいとぶるー	アズライトブルー	名詞	
あといちめーとる	あと1メートル	名詞	
あなたとゆめとぽっぷろっく	あなたと夢とポップロック	名詞	
あめいじんぐはっぴーまん	Amazing Happy Man!!!!!	名詞	
あれすぺくたぶるしょうたいむ	a Respectable Showtime	名詞	
あんちわーるど	Anti world	名詞	
あんてぃーくめもりー	antique memory	名詞	
いみなくない	意味ナクナイ？	名詞	
えたーなるぷれいすだいいちがくしょう	Eternal Place 第一楽章	名詞	
えたーなるぷれいすだいさんがくしょう	Eternal Place 第三楽章	名詞	
えたーなるぷれいすだいにがくしょう	Eternal Place 第二楽章	名詞	
おーでぃなりーらぶ	ORDINARY LOVE	名詞	
かーてんらいず	Curtain raise	名詞	
きみがくれたひかり	君がくれた光	名詞	
きみをまもりたい	君を守りたい	名詞	
きょうのわたしをこえて	今日のわたしをこえて	名詞	
ぐっどしぇぱーど	Good Shepherd	名詞	
くつひも	くつひも	名詞	
くれいじーいーじーもーど	Crazy Easy Mode	名詞	
こかるて	コカルテ	名詞	
こくーん	Cocoon	名詞	
ことばのまほう	ことばの魔法	名詞	
こんとらすと	コントラスト	名詞	
ざすたーとおぶふぇにっくす	The Start of Phoenix	名詞	
さんじゅうろくど	36℃	名詞	
してぃ	CITY	名詞	
しゃぼん	シャボン	名詞	
しゅしゅしゅ	しゅしゅしゅ	名詞	
しょこらふれーず	ショコラ フレーズ	名詞	
しんあいなるまいめん	親愛なるMyメン	名詞	
しんでれらたいむ	シンデレラタイム	名詞	
すてらのひかり	ステラノヒカリリ	名詞	
すとーりーてりんぐ	Storytelling	名詞	
すとろべりーえごいすと	Strawberry Egoist	名詞	
ぜんしんぜんれい	ゼンシンゼンレイ	名詞	
そーすうぃーと	So Sweet	名詞	
たまゆら	玉響	名詞	
つくよみむーんらいと	月夜見Moonlight	名詞	
つながるりんぐ	繋がる縁 -ring-	名詞	
てぃあーど	Tiered	名詞	
でぃありー	Dearly	名詞	
どーなつりんぐわーるど	Donut Ring World	名詞	
とけるみたい	溶けるみたい	名詞	
のーらいふこーど	NO LIFE CODE	名詞	
ぱーぷるあいしゃどう	パープルアイシャドウ	名詞	
はいたっち	ハイタッチ	名詞	
ばたふらいえふぇくと	Butterfly Effect	名詞	
はつこい	はつこい	名詞	
ぱぱぱ	パパパ	名詞	
はぴねす	Happiness	名詞	
はるかなるそらをかけるとりのように	遙かなる時空-そら-を翔ける 不死鳥-とり-のように	名詞	
ひーろーになりたかった	ヒーローになりたかった	名詞	
ひかりいろのうた	ヒカリイロの歌	名詞	
ひかりとあめ	光と雨	名詞	
ひとりあるき	ひとり歩き	名詞	
ぷーるさいどかくてる	プールサイドカクテル	名詞	
ふぉー	for...	名詞	
ふゅーちゃーいずしりあす	future is serious	名詞	
ふゅーちゃーらいん	FUTURE LINE	名詞	
ぶるーあわー	ブルーアワー	名詞	
ぽいずんがーる	Poison Girl	名詞	
ほしでつきでたいようだ	星で月で太陽だ！	名詞	
ぽっぷこーんのくも	ポップコーンの雲	名詞	
ぼんじょうしんでれらのしるけのあるおねがい	凡常シンデレラの汁気のあるお願い	名詞	
まいぷろろーぐ	My Prologue	名詞	
まかろんらぶ	マカロンラブ	名詞	
まつりずむ	祭リズム	名詞	
みー	ME	名詞	
みらーみらー	Mirror Mirror	名詞	
めるろーてぃあーず	Merlot Tears	名詞	
もーにんぐぐろー	Morning glow	名詞	
もしかなうなら	もし叶うなら	名詞	
もっとたかく	もっと高く	名詞	
やさしさのなまえ	やさしさの名前	名詞	
ゆあうぇいまいうぇい	Your Way My Way	名詞	
ゆらゆらら	ゆらゆらら	名詞	
ゆれていたい	揺れていたい	名詞	
よわむししぐなる	弱虫シグナル	名詞	
らいらっく	Lilac	名詞	
らぶそんぐをかけて	ラブソングをかけて	名詞	
りふれくらいと	リフレクライト	名詞	
りまいんど	REMAINED	名詞	
ろーたす	Lotus	名詞	
わいのひげき	Yの悲劇	名詞	
わんだーらんど	Wonderland!!	名詞	
きゃるとあじゅえ	cartes Á jouer 	名詞	
あんすーるえとわーるりとむでて	An seule étoile ～Rythme d'été～	名詞	
あんすーるえとわーる	An seule étoile	名詞	
すーぱーぷーぼあ	Super-pouvoir	名詞	
		名詞	
		名詞	
