あいうた	愛うた	名詞	
あいだ	逢田	名詞	
あいだりかこ	逢田梨香子	名詞	
あうぇいくんざぱわー	Awaken the power	名詞	
あおじゃん	青ジャン	名詞	
あおぞらじゃんぴんぐはーと	青空Jumping Heart	名詞	
あくあ	Aqours	名詞	
あくあうらのほしじょがくいんらじお	Aqours浦の星女学院RADIO!!!	名詞	
あくあくらぶ	AqoursCLUB	名詞	
あくあひーろーず	Aqours☆HEROES	名詞	
あぜりあ	AZALEA	名詞	
いなみあんじゅ	伊波杏樹	名詞	
いのせんとばーど	INNOCENT BIRD	名詞	
いんでぃすあんすていぶるわーるど	in this unstable world	名詞	
いんふぇるのふぇにっくす	インフェルノフェニックス	名詞	
うぉーたーぶるーにゅーわーるど	WATER BLUE NEW WORLD	名詞	
うらじょ	浦女	名詞	
うらのほしじょがくいん	浦の星女学院	名詞	
おはらまり	小原鞠莉	名詞	
おもいよひとつになれ	想いよひとつになれ	名詞	
おもひと	想ひと	名詞	
おやすみなさん	おやすみなさん！	名詞	
かいがんどおりでまってるよ	海岸通りで待ってるよ	名詞	
かずのせいら	鹿角聖良	名詞	
かずのりあ	鹿角理亜	名詞	
かなん	果南	名詞	
きせきひかる	キセキヒカル	名詞	
きみここ	君ここ	名詞	
きみのこころはかがやいているかい	君のこころは輝いてるかい?	名詞	
きめたよはんどいんはんど	決めたよHand in Hand	名詞	
ぎゃらくしーはいどあんどしーく	GALAXY HidE and SeeK	名詞	
ぎるてぃあいずふぃーばー	Guilty Eyes Fever	名詞	
ぎるてぃきす	Guilty Kiss	名詞	
ぎるてぃないとぎるてぃきす	Guilty Night, Guilty Kiss!	名詞	
ぎるない	ギルナイ	名詞	
ぎんかく	GHaS	名詞	
きんみらいはっぴーえんど	近未来ハッピーエンド	名詞	
きんめだい	金目鯛	名詞	
ぐーりんぱ	ラブライブ！サンシャイン!! Aqours浦の星女学院RADIO!!!	名詞	
ぐーりんぱ	ぐ～りんぱ	名詞	
くにきだはなまる	国木田花丸	名詞	
くらっしゅまいんど	CRASH MIND	名詞	
くろさわだいや	黒澤ダイヤ	名詞	
くろさわるびぃ	黒澤ルビィ	名詞	
げんきぜんかいでいでいでい	元気全開DAY！DAY！DAY！	名詞	
こいあく	恋アク	名詞	
こいになりたいあくありうむ	恋になりたいAQUARIUM	名詞	
こばやしあいか	小林愛香	名詞	
こみやありさ	小宮有紗	名詞	
こわれやすき	コワレヤスキ	名詞	
さいとうしゅか	斉藤朱夏	名詞	
さかなかなんだか	さかなかなんだか？	名詞	
さくらうちりこ	桜内梨子	名詞	
さんしゃいんぴっかぴかおんど	サンシャインぴっかぴか音頭	名詞	
じーせんじょうのしんでれら	G線上のシンデレラ	名詞	
じーでれら	Gデレラ	名詞	
しまねぇ	志満ねぇ	名詞	
じもあい	地元愛	名詞	
じもあいまんたんさまーらいふ	地元愛♡満タン☆サマーライフ	名詞	
じゃーにーとぅざさんしゃいん	Journey to the Sunshine	名詞	
しゃどうげいととぅらぶ	Shadow gate to love	名詞	
しゃどげ	シャドゲ	名詞	
しゃろん	CYaRon	名詞	
しょうじょいじょうのこいがしたい	少女以上の恋がしたい	名詞	
しょうじょこい	少女恋	名詞	
じんぐるべるがとまらない	ジングルベルがとまらない	名詞	
すかいじゃーにー	SKY JOURNEY	名詞	
すずきあいな	鈴木愛奈	名詞	
すてっぷぜろとぅわん	Step! ZERO to ONE	名詞	
すととら	ストトラ	名詞	
すとろべりーとらっぱー	Strawberry Trapper	名詞	
すりりんぐわんうぇい	スリリング・ワンウェイ	名詞	
すりわん	スリワン	名詞	
すわななか	諏訪ななか	名詞	
せいいの	聖祈	名詞	
せいなるひのいのり	聖なる日の祈り	名詞	
せいら	聖良	名詞	
せいんとあくあすのう	Saint Aqours Snow	名詞	
せいんとすのう	Saint Snow	名詞	
せーりんぐとぅざさんしゃいん	Sailing to the Sunshine	名詞	
せるふこんとろーる	SELF CONTROL!!	名詞	
ぜろわん	01	名詞	
そらこころはれ	空心晴	名詞	
そらもこころもはれるから	空も心も晴れるから	名詞	
だいすきだったらだいじょうぶ	ダイスキだったらダイジョウブ！	名詞	
たいようをおいかけろ	太陽を追いかけろ！	名詞	
たかつきかなこ	高槻かなこ	名詞	
たかみしま	高海志満	名詞	
たかみちか	高海千歌	名詞	
たかみみと	高海美渡	名詞	
だだだ	ダだダ	名詞	
ちか	千歌	名詞	
つしまよしこ	津島善子	名詞	
でいでいでい	DDD	名詞	
でいどり	デイドリ	名詞	
でいどりーむうぉーりあ	Daydream Warrior	名詞	
ときめきぶんるいがく	ときめき分類学	名詞	
とどかないほしだとしても	届かない星だとしても	名詞	
とどほし	届星	名詞	
とりこりこ	トリコリコ	名詞	
とりこりこぷりーず	トリコリコPLEASE!!	名詞	
どろっぷあうと	DROPOUT!?	名詞	
とわいらいとたいがー	トワイライトタイガー	名詞	
なつとびえんど	なつとびエンド	名詞	
なつねば	夏ねば	名詞	
なつのおわりのあまおとが	夏の終わりの雨音が	名詞	
なつへのとびら	夏への扉	名詞	
なつへのとびらねばーえんどさまー	夏への扉 Never end ver.	名詞	
にゅーわいんでぃんぐろーど	New winding road	名詞	
はっぴーぱーてぃーとれいん	HAPPY PARTY TRAIN	名詞	
はなまる	花丸	名詞	
はには	ハニハ	名詞	
はみふれ	ハミフレ	名詞	
はみんぐふれんど	ハミングフレンド	名詞	
はりけーんぶろっさむ	ハリケーンブロッサム	名詞	
はんどいんはんど	HiH	名詞	
ぴあのふぉるてものろーぐ	Pianoforte Monologue	名詞	
ぴーえすのむこうがわ	P.S.の向こう側	名詞	
びぎなーずせーりんぐ	Beginner's Sailing	名詞	
ふりはたあい	降幡愛	名詞	
ぽっぷす	pops	名詞	
ほっぷすてっぷわーい	ホップ・ステップ・ワーイ！	名詞	
ぽっぷすはーとでおどるんだもん	Pops heartで踊るんだもん！	名詞	
ほわいとふぁーすとらぶ	WHITE FIRST LOVE	名詞	
まいまい	MY舞	名詞	
まいまいとぅないと	MY舞☆TONIGHT	名詞	
まいりすととぅゆー	“MY LIST” to you!	名詞	
まちうた	待歌	名詞	
まつうらかなん	松浦果南	名詞	
まっててあいのうた	待ってて愛のうた	名詞	
まなつはだれのもの	真夏は誰のモノ？	名詞	
まり	鞠莉	名詞	
みじゅくどりーまー	未熟DREAMER	名詞	
みとねぇ	美渡ねぇ	名詞	
みどり	未ドリ	名詞	
みらいちけっと	MIRAI TICKET	名詞	
みらいのぼくらはしってるよ	未来の僕らは知ってるよ	名詞	
みらくるうえーぶ	MIRACLE WAVE	名詞	
みらちけ	ミラチケ	名詞	
みらぼく	未来僕	名詞	
ゆうきはどこにきみのむねに	勇気はどこに?君の胸に!	名詞	
ゆうきみ	勇気君	名詞	
ゆにこーんぶりざーど	ユニコーンブリザード	名詞	
ゆめかたるよりゆめうたおう	ユメ語るよりユメ歌おう	名詞	
ゆめでよぞらをてらしたい	夢で夜空を照らしたい	名詞	
ゆめゆめ	ユメユメ	名詞	
ゆめよぞら	夢夜空	名詞	
よう	曜	名詞	
よしこ	善子	名詞	
よぞらはなんでもしってるの	夜空はなんでも知ってるの？	名詞	
らんあく	ランアク	名詞	
らんでぃんぐあくしょんいぇー	Landing action Yeah!!	名詞	
りあ	理亞	名詞	
りこ	梨子	名詞	
れっどじぇむうぃんく	RED GEM WINK	名詞	
ろんりーちゅーにんぐ	LONELY TUNING	名詞	
わくわくうぃーく	Waku-Waku-Week!	名詞	
わたなべよう	渡辺曜	名詞	
わんだふるすとーりーず	WONDERFUL STORIES	名詞	
わんもあさんしゃいんすとーりー	One More Sunshine Story	名詞	
