BOF	B.O.F	名詞	
さーくりんぐ	CiRCLING	名詞	
あいばあいな	相羽あいな	名詞	
あいみ	愛美	名詞	
あおばもか	青葉モカ	名詞	
あけさかさとみ	明坂聡美	名詞	
あさひなまどか	朝日奈丸佳	名詞	
あふたーぐろう	Afterglow	名詞	
ありさ	有咲	名詞	
いえすばんどり	Yes! BanG_Dream!	名詞	
いちがやありさ	市ヶ谷有咲	名詞	
いとうみく	伊藤美来	名詞	
いまいりさ	今井リサ	名詞	
うえさかすみれ	上坂すみれ	名詞	
うえはらひまり	上原ひまり	名詞	
うざわりぃ	鵜沢リィ	名詞	
うしごめゆり	牛込ゆり	名詞	
うしごめりみ	牛込りみ	名詞	
うだがわあこ	宇田川あこ	名詞	
うだがわともえ	宇田川巴	名詞	
うみのなつき	海野夏希	名詞	
えがおのおーけすとら	えがおのオーケストラっ！	名詞	
えんどうゆりか	遠藤ゆりか	名詞	
おおつかさえ	大塚紗英	名詞	
おおはしあやか	大橋彩香	名詞	
おくさわみさき	奥沢美咲	名詞	
おざわあり	小澤亜李	名詞	
おぺらおぶざうぇいすとらんど	Opera of the wasteland	名詞	
かすみ	香澄	名詞	
かとうえみり	加藤英美里	名詞	
かねもとひさこ	金元寿子	名詞	
かのん	花音	名詞	
かわばたまゆ	川端真結	名詞	
きせき	軌跡	名詞	
きたざわはぐみ	北沢はぐみ	名詞	
きったいずみ	橘田いずみ	名詞	
きみにもらったもの	キミにもらったもの	名詞	
きらきらだとかゆめだとかしんぐがーるず	キラキラだとか夢だとか～Sing Girls～	名詞	
くぃんてぃぷるすまいる	クィンティプル☆すまいる	名詞	
くどうはるか	工藤晴香	名詞	
くりすますのうた	クリスマスのうた	名詞	
ぐりったーぐりーん	Glitter*Green	名詞	
くろさわともよ	黒沢ともよ	名詞	
ごーかごーかいふぁんとむしーふ	ゴーカ！ ごーかい！？ ファントムシーフ！	名詞	
さーくりんぐ	CiRCLING	名詞	
さーくる	CiRCLE	名詞	
さあや	紗綾	名詞	
さくらあやね	佐倉綾音	名詞	
さくらがわめぐ	櫻川めぐ	名詞	
ささきみこい	佐々木未来	名詞	
ざっといずはうあいろーる	That Is How I Roll!!	名詞	
さばいばーねばーぎぶあっぷ	SURVIVORねばーぎぶあっぷ	名詞	
さよ	紗夜	名詞	
じゃんぼりーじゃーにー	Jamboree!Journey!	名詞	
しゅわりんどりーみん	しゅわりん☆どり～みん	名詞	
しらさぎちさと	白鷺千聖	名詞	
しろかねりんこ	白金燐子	名詞	
すかーれっとすかい	Scarlet Sky	名詞	
すすきなんかじゃない	す、好きなんかじゃない！	名詞	
すたーびーとほしのこどう	STAR BEAR!～ホシノコドウ～	名詞	
すぺーす	SPACE	名詞	
せかいのっびのびとれじゃー	せかいのっびのびトレジャー！	名詞	
せたかおる	瀬田薫	名詞	
せんかいうるんだそら	1000回潤んだ空	名詞	
たいこさとみ	大湖里実	名詞	
たいむらぷす	Time Lapse	名詞	
たどころあずさ	田所あずさ	名詞	
だぶるれいんぼう	二重の虹	名詞	
ちさと	千聖	名詞	
ちすぱ	CHiSPA	名詞	
ちょこれいとのていおんれしぴ	チョコレイトの低音レシピ	名詞	
つるまきこころ	弦巻こころ	名詞	
てぃあどろっぷす	ティアドロップス	名詞	
でたみねーしょんしんふぉにー	Determination Symphony	名詞	
てんかとーいつえーとぅずぃー	天下トーイツA to Z☆	名詞	
とぅるーからー	True color	名詞	
とおいおんがくはーとびーと	遠い音楽～ハートビート～	名詞	
どきどきしんぐあうと	どきどきSING OUT!	名詞	
ときめきえくすぺりえんす	ときめきエクスペリエンス	名詞	
とくいそら	徳井青空	名詞	
とやまかすみ	戸山香澄	名詞	
とよだもえ	豊田萌絵	名詞	
どんとびーあふれいど	Don't be afraid!	名詞	
なかじまゆき	中島由貴	名詞	
なついろさんさんせぶん	夏色 SUN! SUN! SEVEN!	名詞	
なつのどーん	夏のドーン！	名詞	
にじっきひなこ	二十騎ひなこ	名詞	
にしもとりみ	西本りみ	名詞	
ねおあすぺくと	Neo-Aspect	名詞	
ねついろすたーまいん	熱色スターマイン	名詞	
はざわつぐみ	羽沢つぐみ	名詞	
はしりはじめたばかりのきみに	走り始めたばかりのキミに	名詞	
ぱすてるぱれっと	Pastel*Palettes	名詞	
ぱすぱれぼりゅーしょんず	パスパレボリューションず☆	名詞	
はたさわこ	秦佐和子	名詞	
はちがつのいふ	八月のif	名詞	
はっぴーはっぴーぱーてぃ	Happy Happy Party!	名詞	
はなぞのたえ	花園たえ	名詞	
はなぞのでんきぎたー	花園電気ギター！！	名詞	
はなまるあんだんて	花丸◎アンダンテ	名詞	
はぴねすはぴぃーまじかる	ハピネスっ！ハピィーマジカルっ！	名詞	
はろーはっぴーわーるど	ハロー、ハッピーワールド！	名詞	
ばんどり	バンドリ	名詞	
ばんどり	BanG Dream!	名詞	
ばんどり	バンドリ！	名詞	
ばんどりがーるずばんどぱーてぃ	バンドリ！ガールズバンドパーティ！	名詞	
ばんどりほしのこどう	BanG_Dream! 星の鼓動	名詞	
ひかさようこ	日笠陽子	名詞	
ひかわさよ	氷川紗夜	名詞	
ひかわひな	氷川日菜	名詞	
ひだまりろーどないと	陽だまりロードナイト	名詞	
ひな	日菜	名詞	
ひろいっくあどべんと	-HEROIC ADVENT-	名詞	
ふくえんみさと	福圓美里	名詞	
ぶらっくしゃうと	BLACK SHOUT	名詞	
ふわふわゆめいろさんどいっち	ふわふわ☆ゆめいろサンドイッチ	名詞	
へいでいかぷりちお	Hey-day狂騒曲	名詞	
ぽっぴんしゃっふる	ぽっぴん’しゃっふる	名詞	
ぽっぴんぱーてぃ	Poppin'Party	名詞	
ほんいずみりな	本泉莉奈	名詞	
まえじまあみ	前島亜美	名詞	
まえへすすめ	前へススメ！	名詞	
まつばらかのん	松原花音	名詞	
まや	麻弥	名詞	
まるやまあや	丸山彩	名詞	
みさわさちか	三澤紗千香	名詞	
みたけらん	美竹蘭	名詞	
みっしぇる	ミッシェル	名詞	
みなとゆきな	湊友希那	名詞	
みなみさき	南早紀	名詞	
みもりすずこ	三森すずこ	名詞	
もりふみか	森文華	名詞	
やっぴーすくーるかーにばる	YAPPY！SCHOOL CARNIVAL☆彡	名詞	
やまとまや	大和麻弥	名詞	
やまぶきさあや	山吹沙綾	名詞	
ゆきな	友希那	名詞	
ゆめみるさんふらわー	夢みるSunflower	名詞	
ゆらゆらりんどんだん	ゆらゆらRing-Dong-Dance	名詞	
よーろー	Y.O.L.O!!!!!	名詞	
よしだゆうり	吉田有里	名詞	
らいとでぃらいと	Light Delight	名詞	
らうだー	LOUDER	名詞	
らん	蘭	名詞	
りばーすでい	Re:birth day	名詞	
りんこ	燐子	名詞	
れじぇんだりー	Legendary	名詞	
ろぜりあ	Roselia	名詞	
わかみやいゔ	若宮イヴ	名詞	
わたしのこいはちょこころね	私の恋はチョココロネ	名詞	
わちゃもちゃぺったんこうしんきょく	わちゃ・もちゃ・ぺったん行進曲	名詞	
わにべななな	鰐部七菜	名詞	
わんだーらんどがーる	WonderlandGirl	名詞	
わんねす	ONENESS	名詞	
