1stlovestory	1st Love Story	名詞	
Encounter	ENCOUNTER	名詞	
Fantasyと	“FA“NTASYと！	名詞	
Fighton	Fight on!	名詞	
Gotoromance	go to Romance>>>>>	名詞	
Graduation	Graduation	名詞	
Immutableribbon	Immutable Ribbon	名詞	
Impossible	I’mpossible？	名詞	
Letmecry	Let me cry	名詞	
Lucelucetwinklewink	Luce Luce Twinkle Wink☆	名詞	
Lucetwinklewink	Luce Twinkle Wink☆	名詞	
Meteorbel	meteor bell	名詞	
Password	Password	名詞	
Precioussummer	Precious☆Summer	名詞	
Seasicemelody	Seaside Melody	名詞	
Shallweluce	Shall we Luce?	名詞	
Shinydayshinylife	Shiny Day, Shiny Life	名詞	
Shinyflower	Shiny flower	名詞	
Shinyjourney	Shiny☆Journey	名詞	
Shinyparade	Shiny☆Parade	名詞	
Strawberryfeels	Strawberryfeels	名詞	
Symphony	Symphony	名詞	
Tresure	Treasure	名詞	
Twinkle5stars	Twinkle“5”stars!!☆	名詞	
Twinklenote	Twinkle Note	名詞	
Wonderfive	Wonder Five	名詞	
Youareastart	You are a star!	名詞	
あいむぽっしぶる	I’mpossible？	名詞	
あまちゃん	あまちゃん	名詞	
いーちゃん	いーちゃん	名詞	
いたやまさおり	板山 紗織	名詞	
いちのせあまね	一ノ瀬 天音	名詞	
いみゅーたぶるりぼん	Immutable Ribbon	名詞	
うさみゆきの	宇佐美 幸乃	名詞	
えんかうんたー	ENCOUNTER	名詞	
かほはむ	かほハム	名詞	
グラジュエーション	Graduation	名詞	
こいいろしこうかいろ	恋色♡思考回路	名詞	
こいのぷろろーぐ	恋のprologue*	名詞	
ごーとぅーろまんす	go to Romance>>>>>	名詞	
さあきゅん	さあきゅん	名詞	
さきもとみお	咲本 美桜	名詞	
しーさいどめろでぃ	Seaside Melody	名詞	
しゃいにーじゃーにー	Shiny☆Journey	名詞	
しゃいにーでいしゃいにーらいふ	Shiny Day, Shiny Life	名詞	
しゃいにーぱれーど	Shiny☆Parade	名詞	
しゃいにーふらわー	Shiny flower	名詞	
しゃるうぃるーちぇ	Shall we Luce?	名詞	
しょうじょたちのびねつ	少女たちの微熱	名詞	
しんふぉにー	Symphony	名詞	
すーぱーまじかるーちぇみらくるとぅるーぱーまじかるーちぇみらーじゅ	ｽｰﾊﾟｰﾏｼﾞｶﾙｰﾁｪﾐﾗｸﾙ☆ﾄｩﾙｰﾊﾟｰﾏｼﾞｶﾙｰﾁｪﾐﾗｰｼﾞｭ	名詞	
すとろべりーふぃーるず	Strawberryfeels	名詞	
せつなはれーしょん	刹那ハレーション	名詞	
せんぼうすたーだむ	羨望スターダム	名詞	
たーみなる	ターミナル	名詞	
たーみなるぼくらあｒべきばしょ	ターミナル ～僕ら、あるべき場所～	名詞	
だいすきすきだいすきすき	 大スキ、スキ、大スキ、スキ、、、、、	名詞	
ちょいびび	ちょいViVi	名詞	
とぅいんくるのーと	Twinkle Note	名詞	
とぅいんくるふぁいぶすたーず	Twinkle“5”stars!!☆	名詞	
とれじゃー	Treasure	名詞	
なぐもめい	南雲 芽依	名詞	
なないろみらい	七色未来	名詞	
なみだいろ	ナミダイロ	名詞	
にんにんはーとでおまじない	にんにんハートでおまじない!	名詞	
ぱすわーど	Password	名詞	
はつこいぺんたぐらむ	初恋☆ペンタグラム	名詞	
はつこいぺんたぐらむImymemineandyou	初恋☆ペンタグラム～I My Me Mine＆You～	名詞	
ひがきかほ	桧垣 果穂	名詞	
ひかり	ヒカリ	名詞	
ふぁーすとらぶすとーりー	1st Love Story	名詞	
ふぁいとおん	Fight on!	名詞	
ふぁんたじーと	“FA“NTASYと！	名詞	
ふゆしよ	冬、しよ？♡	名詞	
ぷれしゃすさまー	Precious☆Summer	名詞	
ぽらりす	ポラリス	名詞	
めいきゅうかたるしす	迷宮カタルシス	名詞	
めいぷる	めいぷる	名詞	
めておべる	meteor bell	名詞	
ゆーあーあすたーと	You are a star!	名詞	
ゆきのしか	ゆきのしか	名詞	
ゆめのそのさき	夢のその先	名詞	
らぶたいむそるじゃー	ラブ×タイムソルジャー	名詞	
らぶたいむそるじゃーみらいときみをゆきかうせんし	ラブ×タイムソルジャー ～未来と君を行き交う戦士～	名詞	
りある	現実-リアル-	名詞	
りんねのすーぱーのゔぁ	輪廻のスーパーノヴァ	名詞	
るーちぇ	Luce Twinkle Wink☆	名詞	
るーちぇとぅいんくるうぃんく	Luce Twinkle Wink☆	名詞	
るーちぇるーちぇとうぃんくるうぃんく	Luce Luce Twinkle Wink☆	名詞	
れっとみーくらい	Let me cry	名詞	
わんだーふぁいぶ	Wonder Five	名詞	
