あーでるはいど	アーデルハイド	名詞	
あいかわ	逢川	名詞	
あいかわめぐみ	逢川 めぐみ	名詞	
あいざわさや	会沢 紗弥	名詞	
あいみ	愛美	名詞	
あいりーん	アイリーン	名詞	
あいりーんれどめいん	アイリーン・レドメイン	名詞	
あおい	蒼井	名詞	
あおいえりか	蒼井 えりか	名詞	
あかり	朱里	名詞	
あさくらかれん	朝倉 可憐	名詞	
あさみ	浅見	名詞	
あさみはるな	浅見 春那	名詞	
あさみまきこ	浅見 真紀子	名詞	
あづきゆうね	亜月 優音	名詞	
あまみゆりな	天海 由梨奈	名詞	
いざわみかこ	井澤 美香子	名詞	
いしいいろは	石井 色葉	名詞	
いすず	五十鈴	名詞	
いずみ	和泉	名詞	
いずみゆき	和泉 ユキ	名詞	
いちこ	一千子	名詞	
いなみあんじゅ	伊波 杏樹	名詞	
いのり	祈	名詞	
いろは	色葉	名詞	
うちだしゅう	内田 秀	名詞	
うちやままり	内山 茉莉	名詞	
ゔりてぃか	ヴリティカ	名詞	
ゔりてぃかばらくりしゅなん	ヴリティカ・バラクリシュナン	名詞	
おおしまいすず	大島 五十鈴	名詞	
おおしまいちこ	大島 一千子	名詞	
おおしまにいな	大島 二以奈	名詞	
おおしまみのり	大島 三野里	名詞	
おおしまむうあ	大島 六宇亜	名詞	
おおしまよつは	大島 四ツ葉	名詞	
おおにしあぐり	大西 亜玖璃	名詞	
おおのゆうこ	大野 柚布子	名詞	
おがさはら	小笠原	名詞	
おがさはらひさめ	小笠原 緋雨	名詞	
おざわあり	小澤 亜李	名詞	
かなた	奏多	名詞	
かねこさやか	金子 彩花	名詞	
かやもり	茅森	名詞	
かやもりるか	茅森 月歌	名詞	
かれん	可憐	名詞	
かわのひより	河野 ひより	名詞	
かんざき	神崎	名詞	
かんざきあーでるはいど	神崎 アーデルハイド	名詞	
きゃろるりーぱー	キャロル・リーパー	名詞	
きりゅう	桐生	名詞	
きりゅうみや	桐生 美也	名詞	
くすのきともり	楠木 ともり	名詞	
くにみ	國見	名詞	
くにみたま	國見 タマ	名詞	
くら	蔵	名詞	
くらさとみ	蔵 里見	名詞	
くろさわまき	黒沢 真希	名詞	
くろせゆうこ	黒瀬 ゆうこ	名詞	
くわはらゆうき	桑原 由気	名詞	
こがあおい	古賀 葵	名詞	
こさかいゆりえ	小坂井 祐莉絵	名詞	
こじまゆい	小島 ゆい	名詞	
こずえ	梢	名詞	
さき	咲	名詞	
さくらばせいら	桜庭 星羅	名詞	
さつき	佐月	名詞	
さつきまり	佐月 マリ	名詞	
さとみ	里見	名詞	
しき	詩紀	名詞	
しゃるろったすこぼふすかや	シャルロッタ・スコボフスカヤ	名詞	
しょうじゆうゆ	少路 裕夕	名詞	
しらかわゆいな	白河 ユイナ	名詞	
しらはなれんか	白花 恋香	名詞	
すがわら	菅原	名詞	
すがわらちえ	菅原 千恵	名詞	
せいか	聖華	名詞	
せいら	星羅	名詞	
せとあさみ	瀬戸 麻沙美	名詞	
せりざわゆう	芹澤 優	名詞	
せんぼんぎあやか	千本木 彩花	名詞	
たざわますみ	田澤 茉純	名詞	
だて	伊達	名詞	
だてあかり	伊達 朱里	名詞	
たま	タマ	名詞	
ちえ	千恵	名詞	
つきしろ	月城	名詞	
つきしろもなか	月城 最中	名詞	
つきやまそのか	築山 苑佳	名詞	
てづか	手塚	名詞	
てづかさき	手塚 咲	名詞	
てんね	天音	名詞	
てんねみこ	天音 巫呼	名詞	
とうごうしえり	東郷 しえり	名詞	
とうじょう	東城	名詞	
とうじょうつかさ	東城 つかさ	名詞	
ときさわかおり	時澤 香保里	名詞	
とりごえまあや	鳥越 まあや	名詞	
なかじまゆき	中島 由貴	名詞	
なかのさいま	中野 さいま	名詞	
なかむらさくら	中村 桜	名詞	
なつめ	夏目	名詞	
なつめいのり	夏目 祈	名詞	
ななせ	七瀬	名詞	
ななせななみ	七瀬 七海	名詞	
ななみ	七海	名詞	
ななみかりん	奈波 果林	名詞	
にいな	二以奈	名詞	
にかいどう	二階堂	名詞	
にかいどうみさと	二階堂 三郷	名詞	
ねもとみやり	根本 京里	名詞	
はないみはる	花井 美春	名詞	
はなむら	華村	名詞	
はなむらしき	華村 詩紀	名詞	
はなもりゆみり	花守ゆみり	名詞	
ばらくりしゅなん	バラクリシュナン	名詞	
ひいらぎこずえ	柊木 梢	名詞	
ひえだねね	稗田 寧々	名詞	
ひぐちせいか	樋口 聖華	名詞	
ひさめ	緋雨	名詞	
ひまわり	向日葵	名詞	
びゃっこ	ビャッコ	名詞	
ふくしまみりい	福嶋 美里衣	名詞	
ふぶき	吹雪	名詞	
ぶんご	豊後	名詞	
ぶんごやよい	豊後 弥生	名詞	
ほしたにみお	星谷 美緒	名詞	
まえかわりょうこ	前川 涼子	名詞	
まきこ	真紀子	名詞	
まつおかちろる	松岡 チロル	名詞	
まつもとさら	松本 沙羅	名詞	
まり	マリ	名詞	
まりあであんじぇりす	マリア・デ・アンジェリス	名詞	
まりか	Marika	名詞	
まるやまかなた	丸山 奏多	名詞	
みおん	美音	名詞	
みこ	巫呼	名詞	
みこと	命	名詞	
みことふぶき	命 吹雪	名詞	
みさと	三郷	名詞	
みずはら	瑞原	名詞	
みずはらあいな	瑞原 あいな	名詞	
みなせいちご	水瀬 いちご	名詞	
みなせすもも	水瀬 すもも	名詞	
みねうちともみ	嶺内 ともみ	名詞	
みのり	三野里	名詞	
みや	美也	名詞	
みやざきたまこ	宮崎 珠子	名詞	
みやしたさき	宮下 早紀	名詞	
みやもとゆめ	宮本 侑芽	名詞	
むうあ	六宇亜	名詞	
むろふし	室伏	名詞	
むろふしりさ	室伏 理沙	名詞	
もなか	最中	名詞	
やなぎみおん	柳 美音	名詞	
やまきあんな	八巻アンナ	名詞	
やまねあや	山根 綺	名詞	
やまわきぼんいゔぁーる	山脇・ボン・イヴァール	名詞	
やよい	弥生	名詞	
ゆいな	ユイナ	名詞	
ゆき	ユキ	名詞	
ゆんしあ	映夏	名詞	
よつは	四ツ葉	名詞	
りー	李	名詞	
りーゆんしあ	李 映夏	名詞	
りさ	理沙	名詞	
るか	月歌	名詞	
れどめいん	レドメイン	名詞	
