あせいくりっどろっと	A Sacred Lot	名詞	靈異伝：タイトル画面テーマ / 幺樂団5：Tr.01
えいえんのみこ	永遠の巫女	名詞	靈異伝：1～4面、地獄16～19面テーマ / 幺樂団5：Tr.02 / 蓬莱人形：Tr.12
ざぽじてぃぶあんどねがてぃぶ	The Positive and Negative	名詞	靈異伝：5面 SinGyokuのテーマ / 幺樂団5：Tr.03
はいりーれすぽんしぶとぅぷれいやーず	Highly Responsive to Prayers	名詞	靈異伝：魔界6～9面テーマ / 幺樂団5：Tr.04
とうほうかいきだん	東方怪奇談	名詞	靈異伝：地獄6～9面テーマ / 幺樂団5：Tr.05 / 蓬莱人形：Tr.05
てんしでんせつ	天使伝説	名詞	靈異伝：10面 YuugenMagan、Mimaのテーマ / 幺樂団5：Tr.06
おりえんたるまじしゃん	Oriental Magician	名詞	靈異伝：魔界11～14面テーマ / 幺樂団5：Tr.07
はじゃのこだち	破邪の小太刀	名詞	靈異伝：地獄11～14面テーマ / 幺樂団5：Tr.08
まきょう	魔鏡	名詞	靈異伝：15面 Elis、Kikuriのテーマ / 幺樂団5：Tr.09
ざれじぇんどおぶかげ	the Legend of KAGE	名詞	幺樂団5：Tr.10
ざれじぇんどおぶかげ	The Legend of KAGE	名詞	靈異伝：16～19面テーマ
いざたおれゆくそのときまで	いざ、倒れ逝くその時まで	名詞	靈異伝：魔界最終面 Sarielのテーマ1 / 幺樂団5：Tr.11
しなばもろとも	死なばもろとも	名詞	靈異伝：魔界最終面 Sarielのテーマ2 
せいゆうけんし	星幽剣士	名詞	靈異伝：地獄最終面 Konngaraのテーマ
せいゆうてんし	星幽天使	名詞	幺樂団5：Tr.13
あいりす	アイリス	名詞	靈異伝：エンディングテーマ / 幺樂団5：Tr.14
かぜのじんじゃ	風の神社	名詞	靈異伝：未使用曲
しびりぜいしょんおぶまじっく	Civilization of Magic	名詞	幺樂団5：Tr.12
てーまおぶいーすたんすとーりー	テーマ・オブ・イースタンストーリー	名詞	幺樂団5：Tr.15
あさcれdぉt	A Sacred Lot	名詞	靈異伝：タイトル画面テーマ / 幺樂団5：Tr.01
てぇぽしちゔぇあんdねがちゔぇ	The Positive and Negative	名詞	靈異伝：5面 SinGyokuのテーマ / 幺樂団5：Tr.03
ひghlyれsぽんしゔぇとpらいぇrs	Highly Responsive to Prayers	名詞	靈異伝：魔界6～9面テーマ / 幺樂団5：Tr.04
はいりーれすぽんしぶとぅぷれあす	Highly Responsive to Prayers	名詞	靈異伝：魔界6～9面テーマ / 幺樂団5：Tr.04
おりえんたlまぎしあん	Oriental Magician	名詞	靈異伝：魔界11～14面テーマ / 幺樂団5：Tr.07
まかがみ	魔鏡	名詞	靈異伝：15面 Elis、Kikuriのテーマ / 幺樂団5：Tr.09
てぇぇげんどfかげ	the Legend of KAGE	名詞	幺樂団5：Tr.10
てぇぇげんどfかげ	The Legend of KAGE	名詞	靈異伝：16～19面テーマ
いざたおれいくそのときまで	いざ、倒れ逝くその時まで	名詞	靈異伝：魔界最終面 Sarielのテーマ1 / 幺樂団5：Tr.11
しゔぃぃざちおのfまぎc	Civilization of Magic	名詞	幺樂団5：Tr.12
てーま・おぶ・いーすたんすとーりー	テーマ・オブ・イースタンストーリー	名詞	幺樂団5：Tr.15
とうほうふうまろくじょうどまんだら	東方封魔録　～ 浄土曼荼羅	名詞	封魔録：タイトル画面テーマ / 幺樂団3：Tr.01
はくれい	博麗　～ Eastern Wind	名詞	封魔録：1面テーマ / 幺樂団3：Tr.02
しーずいんあてんぱー	She's in a temper!!	名詞	封魔録：1面ボス・里香のテーマ / 幺樂団3：Tr.03
えんどおぶでいらいと	End of Daylight	名詞	封魔録：2面テーマ / 幺樂団3：Tr.04
やみのちから	やみのちから	名詞	封魔録：2面ボス・明羅のテーマ / 幺樂団3：Tr.05
げんむかい	幻夢界	名詞	封魔録：3面テーマ / 幺樂団3：Tr.06
しをとして	死を賭して	名詞	封魔録：3面ボスのテーマ / 幺樂団3：Tr.07
ひもろぎむらさきにもえ	ひもろぎ、むらさきにもえ	名詞	封魔録：4面テーマ / 幺樂団3：Tr.08
こいいろまじっく	恋色マジック	名詞	封魔録：4面ボス・魔理沙のテーマ / 幺樂団3：Tr.09 / 萃夢想：魔理沙(昼)のテーマ / 非想天則：魔理沙のテーマ
とうほうふうまろくゆうげんらんぶ	東方封魔録　～ 幽幻乱舞	名詞	封魔録：5面テーマ / 幺樂団3：Tr.10
こんぷりーとだーくねす	Complete Darkness	名詞	封魔録：5面ボス・魅魔のテーマ / 幺樂団3：Tr.11
えきすとららぶ	エキストララブ	名詞	封魔録：Extraテーマ / 幺樂団3：Tr.12
せんしゃむすめのみるゆめ	戦車むすめのみるゆめ	名詞	封魔録：Extraボス・里香のテーマ / 幺樂団3：Tr.13
とおののもり	遠野の森	名詞	封魔録：エンディングテーマ / 幺樂団3：Tr.14
むかしばなしわんだーらんど	昔話わんだーらんど	名詞	封魔録：スタッフロールテーマ / 幺樂団3：Tr.15
はくれいじんじゃけいだい	博麗神社境内	名詞	封魔録：未使用曲(1面テーマ) / 幺樂団3：Tr.16
ひおちて	陽落ちて	名詞	封魔録：未使用曲(2面テーマ) / 幺樂団3：Tr.17
ふうましゅうえん	封魔終演	名詞	封魔録：未使用曲(スタッフロールテーマ) / 幺樂団3：Tr.18
じょうどまんだら	東方封魔録　～ 浄土曼荼羅	名詞	封魔録：タイトル画面テーマ / 幺樂団3：Tr.01
ゆうげんらんぶ	東方封魔録　～ 幽幻乱舞	名詞	封魔録：5面テーマ / 幺樂団3：Tr.10
とうほうふうまろく	東方封魔録　～ 幽幻乱舞	名詞	封魔録：5面テーマ / 幺樂団3：Tr.10
とうほうふうまろく	東方封魔録　～ 浄土曼荼羅	名詞	封魔録：タイトル画面テーマ / 幺樂団3：Tr.01
しぇしなてmぺr	She's in a temper!!	名詞	封魔録：1面ボス・里香のテーマ / 幺樂団3：Tr.03
えんどfだyぃght	End of Daylight	名詞	封魔録：2面テーマ / 幺樂団3：Tr.04
こmpぇてだrkねss	Complete Darkness	名詞	封魔録：5面ボス・魅魔のテーマ / 幺樂団3：Tr.11
ゆめはじくうをこえて	夢は時空を越えて	名詞	夢時空：タイトル画面テーマ / 幺樂団4：Tr.01
せれくしょん	Selection	名詞	夢時空：使用キャラ選択のテーマ / 幺樂団4：Tr.02
とうほうようれんだん	東方妖恋談	名詞	夢時空：靈夢のテーマ / 幺樂団4：Tr.03 / 萃：霊夢(昼)のテーマ / 緋：霊夢のテーマ / 非：「夢想天生」BGM
りーいんかーねいしょん	Reincarnation	名詞	夢時空：魅魔のテーマ / 幺樂団4：Tr.04 // [リーインカーネイション] 蓬莱人形：Tr.10
でぃむどりーむ	Dim. Dream	名詞	夢時空：魔理沙のテーマ / 幺樂団4：Tr.05
たぶららさ	Tabula rasa　～ 空白少女	名詞	夢時空：エレンのテーマ / 幺樂団4：Tr.06
まにあかるぷりんせす	Maniacal Princess	名詞	夢時空：小兎姫のテーマ / 幺樂団4：Tr.07
ゆめしょうしつ	夢消失　～ Lost Dream	名詞	夢時空：カナのテーマ / 幺樂団4：Tr.08
むげんゆうぎ	夢幻遊戯　～ Dream War	名詞	夢時空：理香子のテーマ / 幺樂団4：Tr.09
まほうけっせん	魔法決戦！　～ Fight it out!	名詞	夢時空：CPU7人目のテーマ / 幺樂団4：Tr.11
せいらーおぶたいむ	Sailor of Time	名詞	夢時空：ちゆりのテーマ / 幺樂団4：Tr.13
すとろべりーくらいしす	Strawberry Crisis!!	名詞	夢時空：夢美のテーマ / 幺樂団4：Tr.15
ひとういつまほうせかいろん	非統一魔法世界論	名詞	夢時空：中ボスデモのテーマ / 幺樂団4：Tr.12
まほうしょうあい	魔法鐘愛	名詞	夢時空：夢美デモのテーマ / 幺樂団4：Tr.14
くおんのゆめ	久遠の夢	名詞	夢時空：共通エンディングテーマ / 幺樂団4：Tr.16
とうほうのあおいそら	東方の青い空	名詞	夢時空：昼のエンディングテーマ / 幺樂団4：Tr.17
えいえんのまんげつ	永遠の満月	名詞	夢時空：夜のエンディングテーマ / 幺樂団4：Tr.18
めいぷるどりーむ	Maple Dream...	名詞	夢時空：スタッフロールテーマ / 幺樂団4：Tr.19
れいじんのきゅうじつ	霊人の休日	名詞	夢時空：ネームレジストのテーマ / 幺樂団4：Tr.21
しょうりでも	勝利デモ	名詞	夢時空：勝利デモのテーマ / 幺樂団4：Tr.10
げーむおーばー	ゲームオーバー	名詞	夢時空：ゲームオーバーのテーマ / 幺樂団4：Tr.20
ときのかぜ	時の風	名詞	夢時空：未使用曲 / 幺樂団4：Tr.22
すたーぼうどりーむ	スターボウドリーム	名詞	夢時空：未使用曲 / 幺樂団4：Tr.23
ふぁんたずまごりあ	Phantasmagoria	名詞	夢時空：未使用曲 / 幺樂団4：Tr.24
せぇcちおん	Selection	名詞	夢時空：使用キャラ選択のテーマ / 幺樂団4：Tr.02
れいんかrなちおん	Reincarnation	名詞	夢時空：魅魔のテーマ / 幺樂団4：Tr.04 // [リーインカーネイション] 蓬莱人形：Tr.10
ぢmどれあm	Dim. Dream	名詞	夢時空：魔理沙のテーマ / 幺樂団4：Tr.05
たぶぁらさ	Tabula rasa　～ 空白少女	名詞	夢時空：エレンのテーマ / 幺樂団4：Tr.06
まにあかlpりんせss	Maniacal Princess	名詞	夢時空：小兎姫のテーマ / 幺樂団4：Tr.07
さいぉろfちめ	Sailor of Time	名詞	夢時空：ちゆりのテーマ / 幺樂団4：Tr.13
stらwべrrycりしs	Strawberry Crisis!!	名詞	夢時空：夢美のテーマ / 幺樂団4：Tr.15
まpぇdれあm	Maple Dream...	名詞	夢時空：スタッフロールテーマ / 幺樂団4：Tr.19
pはんたsまごりあ	Phantasmagoria	名詞	夢時空：未使用曲 / 幺樂団4：Tr.24
げんそうきょう	幻想郷　～ Lotus Land Story	名詞	幺樂団1：Tr.01
げんそうきょう	幻想郷　～ Lotus Land Story...	名詞	幻想郷：タイトル画面テーマ
うぃっちんぐどりーむ	Witching Dream	名詞	幻想郷：靈夢1面テーマ / 幺樂団1：Tr.02
せれんずらいと	Selene's light	名詞	幻想郷：魔理沙1面テーマ / 幺樂団1：Tr.03
そうしょくせん	装飾戦　～ Decoration Battle　(未使用バージョン)	名詞	幺樂団1：Tr.29
そうしょくせん	装飾戦　～ Decoration Battle	名詞	幻想郷：1面ボス・オレンジのテーマ / 幺樂団1：Tr.04
ぶれいくざさばす	Break the Sabbath	名詞	幻想郷：2面テーマ / 幺樂団1：Tr.05
こうきょうきょく	紅響曲　～ Scarlet Phoneme	名詞	幻想郷：2面ボス・くるみのテーマ / 幺樂団1：Tr.06
ばっどあっぷる	Bad Apple!!	名詞	幻想郷：3面テーマ / 幺樂団1：Tr.07
れいせん	霊戦　～ Perdition crisis	名詞	幻想郷：3面ボス・エリーのテーマ / 幺樂団1：Tr.08
ありすまえすてら	アリスマエステラ	名詞	幻想郷：4面テーマ / 幺樂団1：Tr.09
しょうじょきそうきょく	少女綺想曲　～ Capriccio	名詞	幻想郷：4面ボス・靈夢テーマ / 幺樂団1：Tr.10 / 萃：霊夢(夜)テーマ // [Dream Battle] 永：4面ボス・霊夢テーマ
ほしのうつわ	星の器　～ Casket of Star	名詞	幻想郷：4面ボス・魔理沙のテーマ / 幺樂団1：Tr.11 / 緋想天：魔理沙のテーマ
ろーたすらぶ	Lotus Love	名詞	幻想郷：5面テーマ / 幺樂団1：Tr.12
ねむれるきょうふ	眠れる恐怖　～ Sleeping Terror	名詞	幻想郷：5面ボス・幽香のテーマ / 幺樂団1：Tr.13
どりーむらんど	Dream Land	名詞	幻想郷：6面テーマ / 幺樂団1：Tr.14
ゆうむ	幽夢　～ Inanimate Dream　(未使用バージョン)	名詞	幺樂団1：Tr.30
ゆうむ	幽夢　～ Inanimate Dream	名詞	幻想郷：6面ボス・幽香のテーマ / 幺樂団1：Tr.15
きんじざるをえないゆうぎ	禁じざるをえない遊戯	名詞	幻想郷：Extraテーマ / 幺樂団1：Tr.16
めいどげんそう	メイド幻想　～ Icemilk Magic	名詞	幻想郷：Extraボス・夢月のテーマ / 幺樂団1：Tr.17
かわいいあくま	かわいい悪魔　～ Innocence	名詞	幻想郷：Extraボス・幻月のテーマ / 幺樂団1：Tr.18
でいず	Days	名詞	幻想郷：バッドエンドのテーマ / 幺樂団1：Tr.19
ぴーすふる	Peaceful	名詞	幻想郷：グッドエンドのテーマ / 幺樂団1：Tr.20
あるかでぃあんどりーむ	Arcadian Dream	名詞	幻想郷：スタッフロールテーマ / 幺樂団1：Tr.21
げんそうのじゅうにん	幻想の住人	名詞	幻想郷：ネームレジストのテーマ / 幺樂団1：Tr.22
ろーたすろーど	Lotus Road	名詞	幻想郷：未使用曲(1面テーマ) / 幺樂団1：Tr.23
どりーみーぱいろっと	Dreamy pilot	名詞	幻想郷：未使用曲(4面テーマ) / 幺樂団1：Tr.24
いんこんぷりーとぷろっと	Incomplete Plot	名詞	幻想郷：未使用曲(5面テーマ) / 幺樂団1：Tr.25
ぼーだーらんど	Border Land	名詞	幻想郷：未使用曲(6面テーマ) / 幺樂団1：Tr.26
まじっくしょっぷおぶらずべりー	Magic Shop of Raspberry	名詞	幻想郷：未使用曲(Extraテーマ) / 幺樂団1：Tr.27
くれっせんとどりーむ	Crescent Dream	名詞	幻想郷：未使用曲(スタッフロールテーマ) / 幺樂団1：Tr.28
うぃtちんgdれあm	Witching Dream	名詞	幻想郷：靈夢1面テーマ / 幺樂団1：Tr.02
せれねずらいと	Selene's light	名詞	幻想郷：魔理沙1面テーマ / 幺樂団1：Tr.03
せぇねsぃght	Selene's light	名詞	幻想郷：魔理沙1面テーマ / 幺樂団1：Tr.03
bれあkてぇさっばth	Break the Sabbath	名詞	幻想郷：2面テーマ / 幺樂団1：Tr.05
ばだppぇ	Bad Apple!!	名詞	幻想郷：3面テーマ / 幺樂団1：Tr.07
ぉつsぉゔぇ	Lotus Love	名詞	幻想郷：5面テーマ / 幺樂団1：Tr.12
dれあmぁんd	Dream Land	名詞	幻想郷：6面テーマ / 幺樂団1：Tr.14
だys	Days	名詞	幻想郷：バッドエンドのテーマ / 幺樂団1：Tr.19
ぺあせふl	Peaceful	名詞	幻想郷：グッドエンドのテーマ / 幺樂団1：Tr.20
あrかぢあんdれあm	Arcadian Dream	名詞	幻想郷：スタッフロールテーマ / 幺樂団1：Tr.21
ぉつsろあd	Lotus Road	名詞	幻想郷：未使用曲(1面テーマ) / 幺樂団1：Tr.23
dれあmyぴぉt	Dreamy pilot	名詞	幻想郷：未使用曲(4面テーマ) / 幺樂団1：Tr.24
いんこmpぇてpぉt	Incomplete Plot	名詞	幻想郷：未使用曲(5面テーマ) / 幺樂団1：Tr.25
ぼrでrかんd	Border Land	名詞	幻想郷：未使用曲(6面テーマ) / 幺樂団1：Tr.26
まぎcしょぽfらspべrry	Magic Shop of Raspberry	名詞	幻想郷：未使用曲(Extraテーマ) / 幺樂団1：Tr.27
cれsせんtdれあm	Crescent Dream	名詞	幻想郷：未使用曲(スタッフロールテーマ) / 幺樂団1：Tr.28
かいきだん	怪綺談　～ Mystic Square	名詞	怪綺談：タイトル画面テーマ / 幺樂団2：Tr.01
どりーむえくすぷれす	Dream Express	名詞	怪綺談：1面テーマ / 幺樂団2：Tr.02
まほうじん	魔法陣　～ Magic Square	名詞	怪綺談：1面ボス・サラのテーマ / 幺樂団2：Tr.03
むそうじくう	夢想時空	名詞	怪綺談：2面テーマ / 幺樂団2：Tr.04
れいてん	霊天　～ Spiritual Heaven	名詞	怪綺談：2面ボス・ルイズのテーマ / 幺樂団2：Tr.05
ろまんちっくちるどれん	Romantic Children	名詞	怪綺談：3面テーマ / 幺樂団2：Tr.06
ぷらすちっくまいんど	プラスチックマインド	名詞	怪綺談：3面ボス・アリスのテーマ / 幺樂団2：Tr.07
めいぷるわいず	メイプルワイズ	名詞	怪綺談：4面テーマ / 幺樂団2：Tr.08
きんだんのまほう	禁断の魔法　～ Forbidden Magic	名詞	怪綺談：4面ボス・二人の魔法使いのテーマ / 幺樂団2：Tr.09
しんくのしょうじょ	真紅の少女　～ Crimson Dead!!	名詞	怪綺談：4面ボス・ユキのテーマ / 幺樂団2：Tr.10
うらぎりのしょうじょ	裏切りの少女　～ Judas Kiss	名詞	怪綺談：4面ボス・マイのテーマ / 幺樂団2：Tr.11
ざらすとじゃっじめんと	the Last Judgement	名詞	怪綺談：5面テーマ / 幺樂団2：Tr.12
かなしきにんぎょう	悲しき人形　～ Doll of Misery	名詞	怪綺談：5面ボス・夢子のテーマ / 幺樂団2：Tr.13
せかいのはて	世界の果て　～ World's End	名詞	怪綺談：6面テーマ / 幺樂団2：Tr.14
しんわげんそう	神話幻想　～ Infinite Being	名詞	怪綺談：6面ボス・神綺のテーマ / 幺樂団2：Tr.15
ふしぎのくにのありす	不思議の国のアリス	名詞	怪綺談：Extraテーマ / 幺樂団2：Tr.16
ぐりもわーるおぶありす	the Grimoire of Alice	名詞	怪綺談：Extraボス・アリスのテーマ / 幺樂団2：Tr.17 / 非想天則：アリスのテーマ
じんじゃ	神社	名詞	怪綺談：バッドエンドのテーマ / 幺樂団2：Tr.18
えんどれす	Endless	名詞	怪綺談：グッドエンドのテーマ1 / 幺樂団2：Tr.19
くおんのらくえん	久遠の楽園	名詞	怪綺談：グッドエンドのテーマ2 / 幺樂団2：Tr.20
みすちっくどりーむ	Mystic Dream	名詞	怪綺談：スタッフロールテーマ / 幺樂団2：Tr.21
ぴーすふるろまんさー	Peaceful Romancer	名詞	怪綺談：Extraエンディングテーマ / 幺樂団2：Tr.23
たましいのやすらむところ	魂の休らむ所	名詞	怪綺談：ネームレジストのテーマ / 幺樂団2：Tr.22
dれあめxpれss	Dream Express	名詞	怪綺談：1面テーマ / 幺樂団2：Tr.02
ろまんちっちldれん	Romantic Children	名詞	怪綺談：3面テーマ / 幺樂団2：Tr.06
てぇぁstじゅdげめんt	the Last Judgement	名詞	怪綺談：5面テーマ / 幺樂団2：Tr.12
てぇgりもいれおふぁぃせ	the Grimoire of Alice	名詞	怪綺談：Extraボス・アリスのテーマ / 幺樂団2：Tr.17 / 非想天則：アリスのテーマ
えんdぇss	Endless	名詞	怪綺談：グッドエンドのテーマ1 / 幺樂団2：Tr.19
mysちcdれあm	Mystic Dream	名詞	怪綺談：スタッフロールテーマ / 幺樂団2：Tr.21
ぺあせふlろまんせr	Peaceful Romancer	名詞	怪綺談：Extraエンディングテーマ / 幺樂団2：Tr.23
あかよりあかいゆめ	赤より紅い夢	名詞	紅魔郷：タイトル画面テーマ
ほおずきみたいにあかいたましい	ほおずきみたいに紅い魂	名詞	紅魔郷：1面テーマ
ようまやこう	妖魔夜行	名詞	紅魔郷：1面ボス・ルーミアのテーマ
るーねいとえるふ	ルーネイトエルフ	名詞	紅魔郷：2面テーマ
おてんばこいむすめ	おてんば恋娘	名詞	紅魔郷：2面ボス・チルノのテーマ / 非想天則：チルノのテーマ
しゃんはいこうちゃかん	上海紅茶館　～ Chinese Tea	名詞	紅魔郷：3面テーマ / 非想天則：美鈴のテーマ / 夢違科学世紀：Tr.03
めいじ17ねんのしゃんはいありす	明治十七年の上海アリス	名詞	紅魔郷：3面ボス・美鈴のテーマ / 蓬莱人形：Tr.04
ゔわるまほうとしょかん	ヴワル魔法図書館	名詞	紅魔郷：4面テーマ / 萃夢想：パチュリー(夜)のテーマ / 非想天則：パチュリーのテーマ
らくとがーる	ラクトガール　～ 少女密室	名詞	紅：4面ボス・パチュリーのテーマ / 萃：パチュリー(昼)のテーマ / 緋：パチュリーのテーマ / 卯酉東海道：Tr.09
めいどとちのかいちゅうどけい	メイドと血の懐中時計	名詞	紅魔郷：5面テーマ / 萃夢想：咲夜(昼)のテーマ
るなだいある	月時計　～ ルナ・ダイアル	名詞	紅魔郷：5面ボス・咲夜のテーマ / 萃夢想：咲夜(夜)のテーマ
つぇぺしゅのおさなきまつえい	ツェペシュの幼き末裔	名詞	紅魔郷：6面テーマ
なきおうじょのためのせぷてっと	亡き王女の為のセプテット	名詞	紅魔郷：6面ボス・レミリアのテーマ / 萃夢想：レミリアのテーマ / 緋想天：レミリアのテーマ
まほうしょうじょたちのひゃくねんさい	魔法少女達の百年祭	名詞	紅魔郷：Extraテーマ
ゆーえぬおーえんはかのじょなのか	U.N.オーエンは彼女なのか？	名詞	紅魔郷：Extraボス・フランドールのテーマ / 蓬莱人形：Tr.11
あかよりはかないえいえん	紅より儚い永遠	名詞	紅魔郷：エンディングテーマ
こうろう	紅楼　～ Eastern Dream...	名詞	紅魔郷：スタッフロールテーマ
めいじじゅうしちねんのしゃんはいありす	明治十七年の上海アリス	名詞	紅魔郷：3面ボス・美鈴のテーマ / 蓬莱人形：Tr.04
めいじじゅうななねんのしゃんはいありす	明治十七年の上海アリス	名詞	紅魔郷：3面ボス・美鈴のテーマ / 蓬莱人形：Tr.04
つきどけい	月時計　～ ルナ・ダイアル	名詞	紅魔郷：5面ボス・咲夜のテーマ / 萃夢想：咲夜(夜)のテーマ
るな・だいある	月時計　～ ルナ・ダイアル	名詞	紅魔郷：5面ボス・咲夜のテーマ / 萃夢想：咲夜(夜)のテーマ
うのーえんはかのじょなのか	U.N.オーエンは彼女なのか？	名詞	紅魔郷：Extraボス・フランドールのテーマ / 蓬莱人形：Tr.11
ようようむ	妖々夢　～ Snow or Cherry Petal	名詞	妖々夢：タイトル画面テーマ
むかうのきょう	無何有の郷　～ Deep Mountain	名詞	妖々夢：1面テーマ
くりすたらいずしるばー	クリスタライズシルバー	名詞	妖々夢：1面ボス・レティのテーマ
とおのげんそうものがたり	遠野幻想物語	名詞	妖々夢：2面テーマ
てぃあおいえつぉん	ティアオイエツォン(withered leaf)	名詞	妖々夢：2面ボス・橙のテーマ
ぶくれしゅてぃのにんぎょうし	ブクレシュティの人形師	名詞	妖々夢：3面テーマ / 萃夢想：アリス(昼)のテーマ / 緋想天：アリスのテーマ
にんぎょうさいばん	人形裁判　～ 人の形弄びし少女	名詞	妖々夢：3面ボス・アリスのテーマ / 夢違科学世紀：Tr.08 // 萃夢想：アリス(夜)のテーマ
てんくうのはなのみやこ	天空の花の都	名詞	妖々夢：4面テーマ
ゆうれいがくだん	幽霊楽団　～ Phantom Ensemble	名詞	妖々夢：4面ボス・プリズムリバー三姉妹のテーマ / 花映塚：プリズムリバー三姉妹のテーマ
とうほうようようむ	東方妖々夢　～ Ancient Temple	名詞	妖々夢：5面テーマ / 萃夢想：妖夢(夜)のテーマ / 花映塚：妖夢のテーマ / 蓮台野夜行：Tr.03
ひろありけてうをいること	広有射怪鳥事　～ Till When?	名詞	妖々夢：5面ボス・妖夢のテーマ / 萃夢想：妖夢(昼)のテーマ / 緋想天：妖夢のテーマ
あるてぃめっととぅるーす	アルティメットトゥルース	名詞	妖々夢：6面テーマ
ゆうがにさかせすみぞめのさくら	幽雅に咲かせ、墨染の桜　～ Border of Life	名詞	妖々夢：6面ボス・幽々子のテーマ1 / 萃夢想：幽々子のテーマ / 緋想天：幽々子のテーマ
ぼーだーおぶらいふ	ボーダーオブライフ	名詞	妖々夢：6面ボス・幽々子のテーマ2
ようようばっこ	妖々跋扈	名詞	妖々夢：Extraテーマ
しょうじょげんそう	少女幻葬　～ Necro-Fantasy	名詞	妖々夢：Extraボス・藍のテーマ / 蓮台野夜行：Tr.10
ようようばっこ	妖々跋扈　～ Who done it!	名詞	妖々夢：Phantasmテーマ (※おまけテキストでは"!"ではなく"?"と記述)
ねくろふぁんたじあ	ネクロファンタジア	名詞	妖々夢：Phantasmボス・紫のテーマ / 大空魔術：Tr.09
はるかぜのゆめ	春風の夢	名詞	妖々夢：エンディングテーマ
さくらさくら	さくらさくら　～ Japanize Dream...	名詞	妖々夢：スタッフロールテーマ
むかうのさと	無何有の郷　～ Deep Mountain	名詞	妖々夢：1面テーマ
ひろありけちょうをいること	広有射怪鳥事　～ Till When?	名詞	妖々夢：5面ボス・妖夢のテーマ / 萃夢想：妖夢(昼)のテーマ / 緋想天：妖夢のテーマ
すみぞめ	幽雅に咲かせ、墨染の桜　～ Border of Life	名詞	妖々夢：6面ボス・幽々子のテーマ1 / 萃夢想：幽々子のテーマ / 緋想天：幽々子のテーマ
しゅんぷうのゆめ	春風の夢	名詞	妖々夢：エンディングテーマ
すいむそう	萃夢想	名詞	萃夢想：タイトル画面テーマ / 非想天則：キャラセレクトのテーマ
まじょたちのぶとうかい	魔女達の舞踏会	名詞	萃夢想：魔理沙(夜)のテーマ // [Magus] 秋霜玉：Extraボス・魔理沙のテーマ
にんぎょうさいばん	人形裁判	名詞	萃夢想：アリス(夜)のテーマ // [人の形弄びし少女] 妖々夢：3面ボス・アリスのテーマ / 夢違科学世紀：Tr.08
でみーすてふぁいふぃーすと	Demystify Feast	名詞	萃夢想：宴会直前の戦闘のテーマ / 大空魔術：Tr.05
よるがおりてくる	夜が降りてくる　～ Evening Star	名詞	萃夢想：紫のテーマ / 夢違科学世紀：Tr.07 // 緋想天：紫のテーマ
おとぎのくにのおにがしま	御伽の国の鬼が島　～ Missing Power	名詞	萃夢想：萃香のテーマ
なつあき	夏明き	名詞	萃夢想：エンディングテーマ
とうほうすいむそう	東方萃夢想	名詞	萃夢想：スタッフロールテーマ
ましょ	魔所	名詞	萃夢想：シナリオ曲
げつりん	月輪	名詞	萃夢想：シナリオ曲
へんさん	遍参	名詞	萃夢想：シナリオ曲
うらごころ	裏心	名詞	萃夢想：シナリオ曲
いんてるめっつぉ	Intermezzo	名詞	萃夢想：シナリオ曲
あゆのかぜ	あゆのかぜ	名詞	萃夢想：シナリオ曲
しんかん	森閑	名詞	萃夢想：会話シーン曲
ぎょうくう	仰空	名詞	萃夢想：会話シーン曲
ゆうきょう	幽境	名詞	萃夢想：会話シーン曲
ちんかく	珍客	名詞	萃夢想：会話シーン曲
こうや	紅夜	名詞	萃夢想：会話シーン曲
せんじん	戦迅	名詞	萃夢想：会話シーン曲
かき	禍機	名詞	萃夢想：会話シーン曲
さいげつ	砕月	名詞	萃夢想：会話シーン曲 / 緋想天：萃香のテーマ
でmysちfyふぇあst	Demystify Feast	名詞	萃夢想：宴会直前の戦闘のテーマ / 大空魔術：Tr.05
いんてるめっぞ	Intermezzo	名詞	萃夢想：シナリオ曲
いんてrめっぞ	Intermezzo	名詞	萃夢想：シナリオ曲
ちんきゃく	珍客	名詞	萃夢想：会話シーン曲
すいげつ	砕月	名詞	萃夢想：会話シーン曲 / 緋想天：萃香のテーマ
えいやしょう	永夜抄　～ Eastern Night.	名詞	永夜抄：タイトル画面テーマ
げんしのよる	幻視の夜　～ Ghostly Eyes	名詞	永夜抄：1面テーマ / 蓮台野夜行：Tr.05
しゅんしゅんしゅうげつ	蠢々秋月　～ Mooned Insect	名詞	永夜抄：1面ボス・リグルのテーマ
よすずめのうたごえ	夜雀の歌声　～ Night Bird	名詞	永夜抄：2面テーマ
もううたしかきこえない	もう歌しか聞こえない	名詞	永夜抄：2面ボス・ミスティアのテーマ // [Flower Mix] 花映塚：ミスティアのテーマ
なつかしきとうほうのち	懐かしき東方の血　～ Old World	名詞	永夜抄：3面テーマ
ぷれいんえいじあ	プレインエイジア	名詞	永夜抄：3面ボス・慧音のテーマ
えいやのむくい	永夜の報い　～ Imperishable Night.	名詞	永夜抄：4面テーマ // 夢違科学世紀：Tr.06
しょうじょきそうきょく	少女綺想曲　～ Dream Battle	名詞	永：4面ボス・霊夢のテーマ // [Capriccio] 幻想郷：4面ボス・靈夢のテーマ / 幺樂団１：Tr.10 / 萃：霊夢(夜)のテーマ
こいいろますたーすぱーく	恋色マスタースパーク	名詞	永夜抄：4面ボス・魔理沙のテーマ / 深秘録：魔理沙のテーマ
しんでれらけーじ	シンデレラケージ　～ Kagome-Kagome	名詞	永夜抄：5面テーマ / Cradle：Tr.16
きょうきのひとみ	狂気の瞳　～ Invisible Full Moon	名詞	永夜抄：5面ボス・鈴仙のテーマ / 花映塚：鈴仙のテーマ / 緋想天：鈴仙のテーマ
ゔぉやーじゅ1969	ヴォヤージュ1969	名詞	永夜抄：6面テーマ / 夢違科学世紀：Tr.04
せんねんげんそうきょう	千年幻想郷　～ History of the Moon	名詞	永夜抄：6面Aボス・永琳のテーマ / 卯酉東海道：Tr.10
たけとりひしょう	竹取飛翔　～ Lunatic Princess	名詞	永夜抄：6面Bボス・輝夜のテーマ / 卯酉東海道：Tr.03
ゔぉやーじゅ1970	ヴォヤージュ1970	名詞	永夜抄：ファイナルスペルのテーマ
えくすてんどあっしゅ	エクステンドアッシュ　～ 蓬莱人	名詞	永夜抄：Extraテーマ
つきまでとどけふしのけむり	月まで届け、不死の煙	名詞	永夜抄：Extraボス・妹紅のテーマ / 深秘録：妹紅のテーマ / 卯酉東海道：Tr.07
つきみそう	月見草	名詞	永夜抄：エンディングテーマ
えたーなるどりーむ	Eternal Dream　～ 幽玄の槭樹	名詞	永夜抄：スタッフロールテーマ // [幽玄の槭樹　～ Eternal Dream] 夢違科学世紀：Tr.11
とうほうようかいこまち	東方妖怪小町	名詞	永夜抄：ラストワードのテーマ
やすずめのうたごえ	夜雀の歌声　～ Night Bird	名詞	永夜抄：2面テーマ
えてrなldれあm	Eternal Dream　～ 幽玄の槭樹	名詞	永夜抄：スタッフロールテーマ // [幽玄の槭樹　～ Eternal Dream] 夢違科学世紀：Tr.11
ゆうげんのかえで	Eternal Dream　～ 幽玄の槭樹	名詞	永夜抄：スタッフロールテーマ // [幽玄の槭樹　～ Eternal Dream] 夢違科学世紀：Tr.11
かえいづか	花映塚　～ Higan Retour	名詞	花映塚：タイトル画面テーマ // [after Higan Retour] 書籍文花帖：Tr.03
はるいろこみち	春色小径　～ Colorful Path	名詞	花映塚：霊夢のテーマ / 心綺楼：stage博麗神社・霊夢のテーマ
おりえんたるだーくふらいと	オリエンタルダークフライト	名詞	花映塚：魔理沙のテーマ
ふらわりんぐないと	フラワリングナイト	名詞	花映塚：咲夜のテーマ / 緋想天：咲夜のテーマ
おてんばこいむすめのぼうけん	おてんば恋娘の冒険	名詞	花映塚：チルノのテーマ / 書籍文花帖：Tr.02
もううたしかきこえない	もう歌しか聞こえない　～ Flower Mix	名詞	花映塚：ミスティアのテーマ // 永夜抄：2面ボス・ミスティアのテーマ
おうささまのしろいはた	お宇佐さまの素い幡	名詞	花映塚：てゐのテーマ / 卯酉東海道：Tr.06
ふうじんしょうじょ	風神少女　(Short Version)	名詞	花映塚：文のテーマ // [Full Version] 文花帖：撮影曲5 / 緋想天：文のテーマ / 書籍文花帖：Tr.01
ぽいずんぼでぃ	ポイズンボディ　～ Forsaken Doll	名詞	花映塚：メディのテーマ
こんじゃくげんそうきょう	今昔幻想郷　～ Flower Land	名詞	花映塚：幽香のテーマ
ひがんきこう	彼岸帰航　～ Riverside View	名詞	花映塚：小町のテーマ / 緋想天：小町のテーマ / 卯酉東海道：Tr.04
60ねんめのとうほうさいばん	六十年目の東方裁判　～ Fate of Sixty Years	名詞	花映塚：四季映姫のテーマ / 伊弉諾物質：Tr.04 // 紫香花：Tr.13
はなのうつるつか	花の映る塚	名詞	花映塚：会話のテーマ1
しがんのつか	此岸の塚	名詞	花映塚：会話のテーマ2
はなはげんそうのままに	花は幻想のままに	名詞	花映塚：エンディングテーマ
たましいのはな	魂の花　～ Another Dream...	名詞	花映塚：スタッフロールテーマ
ろくじゅうねんめのとうほうさいばん	六十年目の東方裁判　～ Fate of Sixty Years	名詞	花映塚：四季映姫のテーマ / 伊弉諾物質：Tr.04 // 紫香花：Tr.13
てんぐのてちょう	天狗の手帖　～ Mysterious Note	名詞	文花帖：タイトル画面テーマ
かぜのじゅんかん	風の循環　～ Wind Tour	名詞	文花帖：撮影曲1
てんぐがみている	天狗が見ている　～ Black Eyes	名詞	文花帖：撮影曲2
ひがしのくにのねむらないよる	東の国の眠らない夜	名詞	文花帖：撮影曲3 / 大空魔術：Tr.03
れとろすぺくてぃぶきょうと	レトロスペクティブ京都	名詞	文花帖：撮影曲4 / 卯酉東海道：Tr.08
ふうじんしょうじょ	風神少女	名詞	文花帖：撮影曲5 / 緋想天：文のテーマ / 書籍文花帖：Tr.01 // [Short Version] 花映塚：文のテーマ
ふういんされしかみがみ	封印されし神々	名詞	風神録：タイトル画面テーマ
ひとこいしかみさま	人恋し神様　～ Romantic Fall	名詞	風神録：1面テーマ
いなだひめさまにしかられるから	稲田姫様に叱られるから	名詞	風神録：1面ボス・穣子のテーマ
やくじんさまのとおりみち	厄神様の通り道　～ Dark Road	名詞	風神録：2面テーマ
うんめいのだーくさいど	運命のダークサイド	名詞	風神録：2面ボス・雛のテーマ
かみがみがこいしたげんそうきょう	神々が恋した幻想郷	名詞	風神録：3面テーマ
あくたがわりゅうのすけのかっぱ	芥川龍之介の河童　～ Candid Friend	名詞	風神録：3面ボス・にとりのテーマ / 心綺楼：stage玄武の沢・にとりのテーマ / 深秘録：にとりのテーマ
ふぉーるおぶふぉーる	フォールオブフォール　～ 秋めく滝	名詞	風神録：4面テーマ
ようかいのやま	妖怪の山　～ Mysterious Mountain	名詞	風神録：4面ボス・文のテーマ / DS：取材のテーマ5 / アマノジャク
しょうじょがみたにほんのげんふうけい	少女が見た日本の原風景	名詞	風神録：5面テーマ
しんこうははかなきにんげんのために	信仰は儚き人間の為に	名詞	風神録：5面ボス・早苗のテーマ / 非想天則：早苗のテーマ
おんばしらのはかば	御柱の墓場　～ Grave of Being	名詞	風神録：6面テーマ
かみさびたこせんじょう	神さびた古戦場　～ Suwa Foughten Field	名詞	風神録：6面ボス・神奈子のテーマ
あしたはれのひけのきのう	明日ハレの日、ケの昨日	名詞	風神録：Extraテーマ / 非想天則：諏訪子のテーマ / 未知の花　魅知の旅：Tr.03
ねいてぃぶふぇいす	ネイティブフェイス	名詞	風神録：Extraボス・諏訪子のテーマ
ふもとのじんじゃ	麓の神社	名詞	風神録：エンディングテーマ
かみはめぐみのあめをふらす	神は恵みの雨を降らす　～ Sylphid Dream	名詞	風神録：スタッフロールテーマ
ぷれいやーずすこあ	プレイヤーズスコア	名詞	風神録：ゲームオーバーのテーマ
やくがみさまのとおりみち	厄神様の通り道　～ Dark Road	名詞	風神録：2面テーマ
しょうじょがみたにっぽんのげんふうけい	少女が見た日本の原風景	名詞	風神録：5面テーマ
かむさびたこせんじょう	神さびた古戦場　～ Suwa Foughten Field	名詞	風神録：6面ボス・神奈子のテーマ
かんさびたこせんじょう	神さびた古戦場　～ Suwa Foughten Field	名詞	風神録：6面ボス・神奈子のテーマ
ひそうてん	緋想天	名詞	緋想天：タイトル画面テーマ
にちじょうざが	日常坐臥	名詞	緋想天：会話シーン曲 / 非想天則：会話シーン曲
ちのいろはきいろ	地の色は黄色	名詞	緋想天：stage博麗神社のテーマ
こうろんおつばく	甲論乙駁	名詞	緋想天：会話シーン曲 / 非想天則：会話シーン曲
ふうこうめいび	風光明媚	名詞	緋想天：会話シーン曲
かおるじゅようか	香る樹葉花	名詞	緋想天：stage魔法の森のテーマ
おどるみずしぶき	踊る水飛沫	名詞	緋想天：stage玄武の沢のテーマ
いぎょくよう	以魚駆蠅	名詞	緋想天：会話シーン曲 / 非想天則：会話シーン曲
ほうしょうふき	放縦不羈	名詞	緋想天：会話シーン曲
あざけりのゆうぎ	嘲りの遊戯	名詞	緋想天：stage妖怪の山のテーマ
れいぎんかんすい	冷吟閑酔	名詞	緋想天：会話シーン曲 / 非想天則：会話シーン曲
うんがいそうてん	雲外蒼天	名詞	緋想天：会話シーン曲
くろいうみにあかく	黒い海に紅く　～ Legendary Fish	名詞	緋想天：衣玖のテーマ
てんいむほう	天衣無縫	名詞	緋想天：会話シーン曲
うちょうてんへん	有頂天変　～ Wonderful Heaven	名詞	緋想天：天子のテーマ
おさなごこちのうちょうてん	幼心地の有頂天	名詞	緋想天：ラストスペルのテーマ
ぼしょくそうぜん	暮色蒼然	名詞	緋想天：エンディングテーマ / 非想天則：エンディングテーマ
とうほうひそうてん	東方緋想天	名詞	緋想天：スタッフロールテーマ
よるがおりてくる	夜が降りてくる	名詞	緋想天：紫のテーマ // [Evening Star] 萃夢想：紫のテーマ / 夢違科学世紀：Tr.07
ほうじゅうふき	放縦不羈	名詞	緋想天：会話シーン曲
うちょうてんぺん	有頂天変　～ Wonderful Heaven	名詞	緋想天：天子のテーマ
おさなここちのうちょうてん	幼心地の有頂天	名詞	緋想天：ラストスペルのテーマ
ちれいたちのきしょう	地霊達の起床	名詞	地霊殿：タイトル画面テーマ
くらやみのふうけつ	暗闇の風穴	名詞	地霊殿：1面テーマ
ふうじられたようかい	封じられた妖怪　～ Lost Place	名詞	地霊殿：1面ボス・ヤマメのテーマ
わたるもののとだえたはし	渡る者の途絶えた橋	名詞	地霊殿：2面テーマ
りょくがんのじぇらしー	緑眼のジェラシー	名詞	地霊殿：2面ボス・パルスィのテーマ
きゅうじごくかいどうをいく	旧地獄街道を行く	名詞	地霊殿：3面テーマ
はなのさかづきおおえやま	華のさかづき大江山	名詞	地霊殿：3面ボス・勇儀のテーマ
はーとふぇるとふぁんしー	ハートフェルトファンシー	名詞	地霊殿：4面テーマ / 伊弉諾物質：Tr.03
しょうじょさとり	少女さとり　～ 3rd eye	名詞	地霊殿：4面ボス・さとりのテーマ
はいごくららばい	廃獄ララバイ	名詞	地霊殿：5面テーマ
したいりょこう	死体旅行　～ Be of good cheer!	名詞	地霊殿：5面ボス・お燐のテーマ
ごうかまんとる	業火マントル	名詞	地霊殿：6面テーマ
れいちのたいようしんこう	霊知の太陽信仰　～ Nuclear Fusion	名詞	地霊殿：6面ボス・空のテーマ / 非想天則：空のテーマ
らすとりもーと	ラストリモート	名詞	地霊殿：Extraテーマ
はるとまんのようかいしょうじょ	ハルトマンの妖怪少女	名詞	地霊殿：Extraボス・こいしのテーマ / 心綺楼：stage地霊殿・こいしのテーマ / 深秘録：こいしのテーマ / 鳥船遺跡：Tr.07
ちれいたちのきたく	地霊達の帰宅	名詞	地霊殿：エンディングテーマ
えねるぎーれいめい	エネルギー黎明　～ Future Dream...	名詞	地霊殿：スタッフロールテーマ
くらやみのかざあな	暗闇の風穴	名詞	地霊殿：1面テーマ
みどりめのじぇらしー	緑眼のジェラシー	名詞	地霊殿：2面ボス・パルスィのテーマ
きゅうじごくかいどうをゆく	旧地獄街道を行く	名詞	地霊殿：3面テーマ
はなのさかずきおおえやま	華のさかづき大江山	名詞	地霊殿：3面ボス・勇儀のテーマ
あおぞらのかげ	青空の影	名詞	星蓮船：タイトル画面テーマ
はるのみなとに	春の湊に	名詞	星蓮船：1面テーマ
ちいさなちいさなけんしょう	小さな小さな賢将	名詞	星蓮船：1面ボス・ナズーリンのテーマ
とざせしくものかよいじ	閉ざせし雲の通い路	名詞	星蓮船：2面テーマ
まんねんおきがさにごちゅういを	万年置き傘にご注意を	名詞	星蓮船：2面ボス・小傘のテーマ
すかいるーいん	スカイルーイン	名詞	星蓮船：3面テーマ
じだいおやじとはいからしょうじょ	時代親父とハイカラ少女	名詞	星蓮船：3面ボス・一輪＆雲山のテーマ / 心綺楼：stage雲上の宝船・一輪＆雲山のテーマ / 深秘録：一輪＆雲山のテーマ
ゆうれいかくせんのじくうをこえたたび	幽霊客船の時空を越えた旅	名詞	星蓮船：4面テーマ
きゃぷてん・むらさ	キャプテン・ムラサ	名詞	星蓮船：4面ボス・ムラサのテーマ
まかいちほうとしえそてりあ	魔界地方都市エソテリア	名詞	星蓮船：5面テーマ
とらがらのびしゃもんてん	虎柄の毘沙門天	名詞	星蓮船：5面ボス・星のテーマ
ほっかいのひ	法界の火	名詞	星蓮船：6面テーマ
かんじょうのまてんろう	感情の摩天楼　～ Cosmic Mind	名詞	星蓮船：6面ボス・白蓮のテーマ / 心綺楼：stage命蓮寺・白蓮のテーマ / 深秘録：白蓮のテーマ / 鳥船遺跡：Tr.09
よぞらのゆーふぉーろまんす	夜空のユーフォーロマンス	名詞	星蓮船：Extraテーマ / 鳥船遺跡：Tr.06
へいあんのえいりあん	平安のエイリアン	名詞	星蓮船：Extraボス・ぬえのテーマ
ようかいでら	妖怪寺	名詞	星蓮船：エンディングテーマ
そらのかえりみち	空の帰り道　～ Sky Dream	名詞	星蓮船：スタッフロールテーマ
とざせしくものかよいぢ	閉ざせし雲の通い路	名詞	星蓮船：2面テーマ
まんねんおきかさにごちゅういを	万年置き傘にご注意を	名詞	星蓮船：2面ボス・小傘のテーマ
ゆうれいきゃくせんのじくうをこえたたび	幽霊客船の時空を越えた旅	名詞	星蓮船：4面テーマ
きゃぷてんむらさ	キャプテン・ムラサ	名詞	星蓮船：4面ボス・ムラサのテーマ
ようかいてら	妖怪寺	名詞	星蓮船：エンディングテーマ
きみはあのかげをみたか	君はあの影を見たか	名詞	非想天則：タイトル画面テーマ
でんせつのきょじん	伝説の巨神	名詞	非想天則：会話シーン曲
ぼくらのひそうてんそく	ぼくらの非想天則	名詞	非想天則：会話シーン曲
にんぎょうのあるふうけい	人形のある風景	名詞	非想天則：会話シーン曲
ゆうきゅうのじょうききかん	悠久の蒸気機関	名詞	非想天則：スタッフロールテーマ
あんのうんえっくす	アンノウンX　～ Unfound Adventure	名詞	非想天則：ラストボスのテーマ / 伊弉諾物質：Tr.08
そらにうかぶぶったいえっくす	空に浮かぶ物体X	名詞	非想天則：ラストスペルのテーマ
にいるれんかちょう	二色蓮花蝶　～ Ancients	名詞	秋霜玉：Extraボス・霊夢のテーマ / 非：霊夢のテーマ // [Red and White] 蓬莱人形：Tr.02 / 深：霊夢のテーマ
でんせつのきょしん	伝説の巨神	名詞	非想天則：会話シーン曲
きょだいなかげとちいさなけつまつ	巨大な影と小さな結末	名詞	非OST：Tr.20
あんのうんx	アンノウンX　～ Unfound Adventure	名詞	非想天則：ラストボスのテーマ / 伊弉諾物質：Tr.08
そらにうかぶぶったいx	空に浮かぶ物体X	名詞	非想天則：ラストスペルのテーマ
にしょくれんかちょう	二色蓮花蝶　～ Ancients	名詞	秋霜玉：Extraボス・霊夢のテーマ / 非：霊夢のテーマ // [Red and White] 蓬莱人形：Tr.02 / 深：霊夢のテーマ
にゅーすはうんど	ニュースハウンド	名詞	DS：タイトル画面テーマ
あなたのまちのかいじけん	あなたの町の怪事件	名詞	DS：取材のテーマ1
ようかいもだんころにー	妖怪モダンコロニー	名詞	DS：取材のテーマ2 / 三月精(第三部)第1巻：Tr.02
めねしすのようさい	ネメシスの要塞	名詞	DS：取材のテーマ3
むけんのかね	無間の鐘　～ Infinite Nightmare	名詞	DS：取材のテーマ4 / 未知の花　魅知の旅：Tr.02
むげんのかね	無間の鐘　～ Infinite Nightmare	名詞	DS：取材のテーマ4 / 未知の花　魅知の旅：Tr.02
はるのひょうせい	春の氷精	名詞	妖精大戦争：タイトル画面テーマ
かわいいだいせんそうのりふれーん	可愛い大戦争のリフレーン	名詞	三月精(第二部)第2巻：Tr.01 / 妖精大戦争：1面テーマ
いたずらにいのちをかけて	いたずらに命をかけて	名詞	妖精大戦争：1、2面ボスのテーマ / 三月精(第三部)第3巻：Tr.02
ねんじゅうむちゅうのこうきしん	年中夢中の好奇心	名詞	妖精大戦争：2面テーマ / 三月精(第三部)第2巻：Tr.01
まよなかのふぇありーだんす	真夜中のフェアリーダンス	名詞	妖精大戦争：3面テーマ / 三月精(第三部)第2巻：Tr.02
ようせいだいせんそう	妖精大戦争　～ Fairy Wars	名詞	妖精大戦争：3面ボスのテーマ / 三月精(第三部)第2巻：Tr.03
るーずれいん	ルーズレイン	名詞	妖精大戦争：Extraテーマ
めいがすないと	メイガスナイト	名詞	妖精大戦争：Extraボス・魔理沙のテーマ / 心綺楼：人間の里・魔理沙のテーマ / 三月精(第三部)第3巻：Tr.01
はるのひょうせい	春の氷精　- 静 -	名詞	妖精大戦争：エンディングテーマ
よくぶかきれいこん	欲深き霊魂	名詞	神霊廟：タイトル画面テーマ
しりょうのよざくら	死霊の夜桜	名詞	神霊廟：1面テーマ
ごーすとりーど	ゴーストリード	名詞	神霊廟：1面ボス・幽々子のテーマ
ようかいでらへようこそ	妖怪寺へようこそ	名詞	神霊廟：2面テーマ
もんぜんのようかいこむすめ	門前の妖怪小娘	名詞	神霊廟：2面ボス・響子のテーマ
すてきなはかばでくらしましょ	素敵な墓場で暮しましょ	名詞	神霊廟：3面テーマ / 伊弉諾物質：Tr.10
りじっどぱらだいす	リジッドパラダイス	名詞	神霊廟：3面ボス・芳香のテーマ
でざいあどらいぶ	デザイアドライブ	名詞	神霊廟：4面テーマ / 鳥船遺跡：Tr.03
ふるきゆあんしぇん	古きユアンシェン	名詞	神霊廟：4面ボス・青娥のテーマ / 三月精(第三部)第3巻：Tr.01
ゆめどのだいしびょう	夢殿大祀廟	名詞	神霊廟：5面テーマ
おおみわしんわでん	大神神話伝	名詞	神霊廟：5面ボス・布都のテーマ / 心綺楼：stage夢殿大祀廟・布都のテーマ / 深秘録：布都のテーマ
ちいさなよくぼうのほしぞら	小さな欲望の星空	名詞	神霊廟：6面テーマ
しょうとくでんせつ	聖徳伝説　～ True Administrator	名詞	神霊廟：6面ボス・神子のテーマ / 心綺楼：stage神霊廟・神子のテーマ / 深秘録：神子のテーマ
ようかいうらさんどう	妖怪裏参道	名詞	神霊廟：Extraテーマ / 伊弉諾物質：Tr.07
さどのふたついわ	佐渡の二ッ岩	名詞	神霊廟：Extraボス・マミゾウのテーマ / 心綺楼：stage妖怪狸の森・マミゾウのテーマ
じんじゃのあたらしいかぜ	神社の新しい風	名詞	神霊廟：エンディングテーマ
でざいあどりーむ	デザイアドリーム	名詞	神霊廟：スタッフロールテーマ
しれいのよざくら	死霊の夜桜	名詞	神霊廟：1面テーマ
げんそうきょうのふたついわ	幻想郷の二ッ岩	名詞	心綺楼：stage妖怪狸の森(夜)・マミゾウのテーマ / 深秘録：マミゾウのテーマ
ぼうしつのえもーしょん	亡失のエモーション	名詞	心綺楼：stage人間の里(夜)・こころのテーマ / 深秘録：こころのテーマ
じんかいふへんのぺしみずむ	塵界不変のペシミズム	名詞	心綺楼：オープニングテーマ
しんきろうばやし	心綺楼囃子	名詞	心綺楼：タイトル画面テーマ
ひとけのあるばしょ	人気のある場所	名詞	心綺楼：会話シーン曲
ひとけのないばしょ	人気のない場所	名詞	心綺楼：会話シーン曲
うしみつどきのさと	丑三つ時の里	名詞	心綺楼：会話シーン曲　こころ戦前
ほんじつのいちめんきじ	本日の一面記事	名詞	心綺楼：勝利のテーマ
ぎょううん	暁雲	名詞	心綺楼：エンディングテーマ
かんぱんたそがれしんぶん	官板黄昏新聞	名詞	心綺楼：スタッフロールテーマ
にんきのあるばしょ	人気のある場所	名詞	心綺楼：会話シーン曲
にんきのないばしょ	人気のない場所	名詞	心綺楼：会話シーン曲
ふしぎなおはらいぼう	不思議なお祓い棒	名詞	輝針城：タイトル画面テーマ
みすとれいく	ミストレイク	名詞	輝針城：1面テーマ
ひきょうのまーめいど	秘境のマーメイド	名詞	輝針城：1面ボス・わかさぎ姫のテーマ / アマノジャク
うんがをいきかうじんよう	運河を行き交う人妖	名詞	輝針城：2面テーマ
やなぎのしたのでゅらはん	柳の下のデュラハン	名詞	輝針城：2面ボス・赤蛮奇のテーマ
まんげつのちくりん	満月の竹林	名詞	輝針城：3面テーマ
こどくなうぇあうるふ	孤独なウェアウルフ	名詞	輝針城：3面ボス・影狼のテーマ
まじかるすとーむ	マジカルストーム	名詞	輝針城：4面テーマ
げんそうじょうるり	幻想浄瑠璃	名詞	輝針城：4面ボス・弁々、八橋のテーマ / アマノジャク
くうちゅうにしずむきしんじょう	空中に沈む輝針城	名詞	輝針城：5面テーマ
りばーすいでおろぎー	リバースイデオロギー	名詞	輝針城：5面ボス・正邪のテーマ / アマノジャク
しんしょうぼうだいのてんしゅかく	針小棒大の天守閣	名詞	輝針城：6面テーマ
かがやくはりのこびとぞく	輝く針の小人族　～ Little Princess	名詞	輝針城：6面ボス・針妙丸のテーマ / 深秘録：針妙丸のテーマ
まりょくのらいうん	魔力の雷雲	名詞	輝針城：Extraテーマ
しげんのびーと	始原のビート　～ Prinstine Beat	名詞	輝針城：Extraボス・雷鼓のテーマ
こづちのまりょく	小槌の魔力	名詞	輝針城：エンディングテーマ
ふしぎなふしぎなどうぐたち	不思議な不思議な道具達	名詞	輝針城：スタッフロールテーマ
うんがをゆきかうじんよう	運河を行き交う人妖	名詞	輝針城：2面のテーマ
はんそくののろしをあげろ	反則の狼煙を上げろ	名詞	アマノジャク：タイトル画面テーマ
ふかのうだんまくにははんそくを	不可能弾幕には反則を	名詞	アマノジャク：最序盤のテーマ
みっどないとすぺるかーど	ミッドナイトスペルカード	名詞	アマノジャク：序盤のテーマ
ろまんちっくとうひこう	ロマンチック逃飛行	名詞	アマノジャク：中盤のテーマ
えいえんのみっかてんか	永遠の三日天下	名詞	アマノジャク：終盤のテーマ
こころゆさぶるとしでんせつ	心揺さぶる都市伝説	名詞	深秘録：タイトル画面テーマ
げんそうきょうふしぎはっけん	幻想郷ふしぎ発見	名詞	深秘録：キャラクター選択画面テーマ
ぼーるのあるにちじょう	ボールのある日常	名詞	深秘録：会話パート1
けんげんしたでんしょうのかたち	顕現した伝承の形	名詞	深秘録：会話パート2
じだいのかぜのおとずれ	時代の風の訪れ	名詞	深秘録：会話パート3
かちがわからない	価値がわからない	名詞	深秘録：会話パート4
かのうせいをしんじて	可能性を信じて	名詞	深秘録：会話パート5
しんじつをしるもの	真実を知る者	名詞	深秘録：会話パート・セミファイナル前
がいかいふぉーくろあ	外界フォークロア	名詞	深秘録：会話パート・ファイナル前
おのおののけつまつ	各々の結末	名詞	深秘録：エンディングテーマ
あかされるしんぴ	明かされる深秘	名詞	深秘録：スタッフロールテーマ
おかるとあらかると	オカルトアラカルト	名詞	深秘録：ストーリーモード専用戦闘曲1
しちぎょくしゅうしゅうしょうだうん	七玉蒐集ショウダウン	名詞	深秘録：ストーリーモード専用戦闘曲2
こうせいなるうばいあい	公正なる奪い合い	名詞	深秘録：ストーリーモード専用戦闘曲3
たいせきちのかね	対蹠地の鐘	名詞	深秘録：ストーリーモード専用戦闘曲4
ちくりんいんふれいむ	竹林インフレイム	名詞	深秘録：ストーリーモード専用戦闘曲5
はなざまのばとるふぃーるど	華狭間のバトルフィールド	名詞	深秘録：華扇のテーマ
らすとおかるてぃずむ	ラストオカルティズム　～ 現し世の秘術師	名詞	深秘録：菫子のテーマ
たいしょちのかね	対蹠地の鐘	名詞	深秘録：ストーリーモード専用戦闘曲4
うちゅうみこあらわる	宇宙巫女現る	名詞	紺珠伝：タイトル画面テーマ
わすれがたきよすがのみどり	忘れがたき、よすがの緑	名詞	紺珠伝：1面テーマ
うさぎはまいおりた	兎は舞い降りた	名詞	紺珠伝：1面ボス・清蘭のテーマ
みずうみはきよめのげっこうをうつして	湖は浄めの月光を映して	名詞	紺珠伝：2面テーマ
くがつのぱんぷきん	九月のパンプキン	名詞	紺珠伝：2面ボス・鈴瑚のテーマ
うちゅうをとぶふしぎなみこ	宇宙を飛ぶ不思議な巫女	名詞	紺珠伝：3面テーマ
えいえんのしゅんむ	永遠の春夢	名詞	紺珠伝：3面ボス・ドレミーのテーマ
こおりついたえいえんのみやこ	凍り付いた永遠の都	名詞	紺珠伝：4面テーマ
ぎゃくてんするほいーるおぶふぉーちゅん	逆転するホイールオブフォーチュン	名詞	紺珠伝：4面ボス・サグメのテーマ
はるか38まんきろのぼやーじゅ	遥か３８万キロのボヤージュ	名詞	紺珠伝：5面テーマ
はるかさんじゅうまんきろのぼやーじゅ	遥か３８万キロのボヤージュ	名詞	紺珠伝：5面テーマ
せいじょうきのぴえろ	星条旗のピエロ	名詞	紺珠伝：5面ボス・クラウンピースのテーマ
こきょうのほしがうつるうみ	故郷の星が映る海	名詞	紺珠伝：6面テーマ
ぴゅあひゅーりーず	ピュアヒューリーズ　～ 心の在処	名詞	紺珠伝：6面ボス・純狐のテーマ
みたこともないあくむのせかい	見た事も無い悪夢の世界	名詞	紺珠伝：Extraテーマ
ぱんでもにっくぷらねっと	パンデモニックプラネット	名詞	紺珠伝：Extraボス・ヘカーティアのテーマ
じんじゃからみえるつき	神社から見える月	名詞	紺珠伝：エンディングテーマ
うちゅうみこきかんする	宇宙巫女帰還する	名詞	紺珠伝：スタッフロールテーマ
ほうらいでんせつ	蓬莱伝説	名詞	蓬莱人形：Tr.01
にいるれんかちょう	二色蓮花蝶　～ Red and White	名詞	蓬莱人形：Tr.02 / 深：霊夢のテーマ // [Ancients] 秋霜玉：Extraボス・霊夢のテーマ / 非：霊夢のテーマ
おうかのこいづか	桜花之恋塚　～ Japanese Flower	名詞	蓬莱人形：Tr.03 // [Flower of Japan] 稀翁玉：幽香のテーマ
えにぐまてぃくどーる	エニグマティクドール	名詞	蓬莱人形：Tr.06 // [God Knows] 稀翁玉：ミューズのテーマ
さーかすれゔぁりえ	サーカスレヴァリエ	名詞	蓬莱人形：Tr.07 // [機械サーカス　～ Reverie] 秋霜玉：4面ボス・マリーのテーマ
にんぎょうのもり	人形の森	名詞	蓬莱人形：Tr.08
うぃっちおぶらぶぽーしょん	Witch of Love Potion	名詞	蓬莱人形：Tr.09 / トルテルマジック：通常面のテーマ
りーいんかーねいしょん	リーインカーネイション	名詞	蓬莱人形：Tr.10 // [Reincarnation] 夢時空：魅魔のテーマ / 幺樂団4：Tr.04
そらとぶみこのふしぎなまいにち	空飛ぶ巫女の不思議な毎日	名詞	蓬莱人形：Tr.13
にしょくれんかちょう	二色蓮花蝶　～ Red and White	名詞	蓬莱人形：Tr.02 / 深：霊夢のテーマ // [Ancients] 秋霜玉：Extraボス・霊夢のテーマ / 非：霊夢のテーマ
うぃtちょfぉゔぇぽちおん	Witch of Love Potion	名詞	蓬莱人形：Tr.09 / トルテルマジック：通常面のテーマ
よるのでんでらのをゆく	夜のデンデラ野を逝く	名詞	蓮台野夜行：Tr.01
しょうじょひふうくらぶ	少女秘封倶楽部	名詞	蓮台野夜行：Tr.02
いにしえのめいかいでら	古の冥界寺	名詞	蓮台野夜行：Tr.04
まじゅつしめりー	魔術師メリー	名詞	蓮台野夜行：Tr.06
つきのようちょうばけねこのまぼろし	月の妖鳥、化猫の幻	名詞	蓮台野夜行：Tr.07
かこのはな	過去の花　～ Fairy of Flower	名詞	蓮台野夜行：Tr.08 / 妖々夢：未使用曲
まほうしょうじょじゅうじぐん	魔法少女十字軍	名詞	蓮台野夜行：Tr.09 / 秋霜玉：5面ボス・エーリッヒのテーマ
げんそうのえいえんさい	幻想の永遠祭	名詞	蓮台野夜行：Tr.11
よるのでんでらのをいく	夜のデンデラ野を逝く	名詞	蓮台野夜行：Tr.01
いにしえのめいかいじ	古の冥界寺	名詞	蓮台野夜行：Tr.04
わらべまつり	童祭　～ Innocent Treasures	名詞	夢違科学世紀：Tr.01 / 東方の夜明け 神主入退場のテーマ
かしょのゆめ	華胥の夢	名詞	夢違科学世紀：Tr.02
かがくせいきのしょうねんしょうじょ	科学世紀の少年少女	名詞	夢違科学世紀：Tr.05
えいやのむくい	永夜の報い　～ Imperishable Night	名詞	夢違科学世紀：Tr.06 // 永夜抄：4面のテーマ
ゆめとうつつのきょうかい	夢と現の境界	名詞	夢違科学世紀：Tr.09
げんそうきかい	幻想機械　～ Phantom Factory	名詞	夢違科学世紀：Tr.10 // [幻想科学　～ Doll's Phantom] 秋霜玉：6面ボスのテーマ2
ゆうげんのかえで	幽玄の槭樹　～ Eternal Dream	名詞	夢違科学世紀：Tr.11 // [Eternal Dream　～ 幽玄の槭樹] 永夜抄：スタッフロールテーマ
ひろしげ36ごう	ヒロシゲ36号　～ Neo Super-Express	名詞	卯酉東海道：Tr.01
53みにっつのあおいうみ	53ミニッツの青い海	名詞	卯酉東海道：Tr.02
あおきがはらのでんせつ	青木ヶ原の伝説	名詞	卯酉東海道：Tr.05
もっともすみわたるそらとうみ	最も澄みわたる空と海	名詞	卯酉東海道：Tr.11
ひろしげさんじゅうろくごう	ヒロシゲ36号　～ Neo Super-Express	名詞	卯酉東海道：Tr.01
ごじゅうさんみにっつのあおいうみ	53ミニッツの青い海	名詞	卯酉東海道：Tr.02
げつめんつあーへようこそ	月面ツアーへようこそ	名詞	大空魔術：Tr.01
てんくうのぐりにっじ	天空のグリニッジ	名詞	大空魔術：Tr.02
くるまいすのみらいうちゅう	車椅子の未来宇宙	名詞	大空魔術：Tr.04
えいせいかふぇてらす	衛星カフェテラス	名詞	大空魔術：Tr.06
じーふりー	G Free	名詞	大空魔術：Tr.07
おおぞらまじゅつ	大空魔術　～ Magical Astronomy	名詞	大空魔術：Tr.08
むこうがわのつき	向こう側の月	名詞	大空魔術：Tr.10
gfれえ	G Free	名詞	大空魔術：Tr.07
gのむこう	Gの向こう	名詞	大空魔術：Tr.07 (G FreeのCD印刷タイトル)
じーのむこう	Gの向こう	名詞	大空魔術：Tr.07 (G FreeのCD印刷タイトル)
みちのはなみちのたび	未知の花　魅知の旅	名詞	未知の花　魅知の旅：Tr.01
えいせいとりふね	衛星トリフネ	名詞	鳥船遺跡：Tr.01
とろやぐんのみつりん	トロヤ群の密林	名詞	鳥船遺跡：Tr.02
ふぇありーぼうけんたん	フェアリー冒険譚	名詞	三月精(第二部)第3巻：Tr.01 / 鳥船遺跡：Tr.04
あめのとりふねじんじゃ	天鳥船神社	名詞	鳥船遺跡：Tr.05
あめのとりふねじんじゃのけっかい	天鳥船神社の結界	名詞	鳥船遺跡：Tr.08
うちゅうにうかぶげんそうきょう	宇宙に浮かぶ幻想郷	名詞	鳥船遺跡：Tr.10
みどりのさなとりうむ	緑のサナトリウム	名詞	伊弉諾物質：Tr.01
うしにひかれてぜんこうじまいり	牛に引かれて善光寺参り	名詞	伊弉諾物質：Tr.02
あがるたのかぜ	アガルタの風	名詞	伊弉諾物質：Tr.05
いざなぎおぶじぇくと	イザナギオブジェクト	名詞	伊弉諾物質：Tr.06
にほんじゅうのふしぎをあつめて	日本中の不思議を集めて	名詞	伊弉諾物質：Tr.09
にっぽんじゅうのふしぎをあつめて	日本中の不思議を集めて	名詞	伊弉諾物質：Tr.09
かえいづか	花映塚　～ after Higan Retour	名詞	書籍文花帖：Tr.03 // [Higan Retour] 花映塚：タイトル画面テーマ
じゃぱにーずさーが	ジャパニーズサーガ	名詞	求聞史紀：Tr.01
あれのこども	阿礼の子供	名詞	求聞史紀：Tr.02
よるのはとやまをとぶ	夜の鳩山を飛ぶ　-Power MIX	名詞	求聞史紀：Tr.03 // Project Gian(秋霜玉プロトタイプ・98年度鳩山祭バージョン)BGM
さにーるちるふれくしょん	サニールチルフレクション	名詞	三月精(第一部)：Tr.01 / 三月精(第二部)第2巻：Tr.02
よるだからねむれない	夜だから眠れない	名詞	三月精(第一部)：Tr.02 / 三月精(第二部)第2巻：Tr.03
ようせいさんさんとして	妖精燦々として	名詞	三月精(第一部)：Tr.03 / 三月精(第二部)第2巻：Tr.04
さにーみるくのこうむいへん	サニーミルクの紅霧異変	名詞	三月精(第二部)第1巻：Tr.01
せつげつおうかのくに	雪月桜花の国	名詞	三月精(第二部)第1巻：Tr.02
すたーゔぉやーじゅ2008	スターヴォヤージュ2008	名詞	三月精(第二部)第1巻：Tr.03
ふたつのせかい	二つの世界	名詞	三月精(第二部)第3巻：Tr.02
2つのせかい	二つの世界	名詞	三月精(第二部)第3巻：Tr.02
しんいきのかくれんぼくらし	神域のかくれんぼ暮らし	名詞	三月精(第三部)第1巻：Tr.01
ようかいうちゅうりょこう	妖怪宇宙旅行	名詞	儚月抄(漫画版)上巻：Tr.01
わたつきのすぺるかーど	綿月のスペルカード　～ Lunatic Blue	名詞	儚月抄(漫画版)上巻：Tr.02
のんべぇのれむりあ	呑んべぇのレムリア (Retro Ver)	名詞	儚月抄(漫画版)上巻：Tr.03 // 黄昏酒場：3面ボス・甘粕・バーレイ・天治のテーマ
まほうつかいのゆううつ	魔法使いの憂鬱	名詞	GoM：Tr.01
すぷーとにくげんや	スプートニク幻夜	名詞	秋霜玉：4面テーマ / GoM：Tr.02
しゅうそうぎょく	秋霜玉　～ Clockworks	名詞	秋霜玉：タイトル画面テーマ
ふぉるすすとろべりー	フォルスストロベリー	名詞	秋霜玉：1面テーマ
ぷりむろーずしゔぁ	プリムローズシヴァ	名詞	秋霜玉：1面ボス・ミリアのテーマ
げんそうていと	幻想帝都	名詞	秋霜玉：2面テーマ
でぃざすとらすじぇみに	ディザストラスジェミニ	名詞	秋霜玉：2面ボス・めい＆まいのテーマ
はなのげんそうこうむのそら	華の幻想　紅夢の宙	名詞	秋霜玉：3面テーマ
てんくうあーみー	天空アーミー	名詞	秋霜玉：3面ボス・ゲイツのテーマ
きかいさーかす	機械サーカス　～ Reverie	名詞	秋霜玉：4面ボス・マリーのテーマ // [サーカスレヴァリエ] 蓬莱人形：Tr.07
かなべらるのむげんしょうじょ	カナベラルの夢幻少女	名詞	秋霜玉：5面テーマ
あんてぃーくてらー	アンティークテラー	名詞	秋霜玉：6面テーマ
ゆめきかい	夢機械　～ Innocent Power	名詞	秋霜玉：6面ボスのテーマ1
げんそうかがく	幻想科学　～ Doll's Phantom	名詞	秋霜玉：6面ボスのテーマ2 // [幻想機械　～ Phantom Factory] 夢違科学世紀：Tr.10
しょうじょしんせい	少女神性　～ Pandora's Box	名詞	秋霜玉：6面ボスのテーマ3
しるくろーどありす	シルクロードアリス	名詞	秋霜玉：Extraテーマ
まじょたちのぶとうかい	魔女達の舞踏会　～ Magus	名詞	秋霜玉：Extraボス・魔理沙のテーマ // 萃夢想：魔理沙(夜)のテーマ
はーせるゔず	ハーセルヴズ	名詞	秋霜玉：エンディングテーマ
たいとるどめいど	タイトルドメイド	名詞	秋霜玉：ネームレジストのテーマ
はなのげんそう	華の幻想　紅夢の宙	名詞	秋霜玉：3面テーマ
きおうぎょく	稀翁玉　～ Fairy Dance	名詞	稀翁玉：タイトル画面テーマ
びろおどしょうじょせん	天鵞絨少女戦　～ Velvet Battle	名詞	稀翁玉：VIVITのテーマ
きゃっするえくすぷろーら	Castle Explorer -in the Sky-	名詞	稀翁玉：ゲイツのテーマ
おるふぇのうた	オルフェの詩　～ Pseudoclassic	名詞	稀翁玉：めい＆まいのテーマ
しんげんそう	新幻想　～ New Fantasy	名詞	稀翁玉：ミリアのテーマ
おるれあんのせいきし	オルレアンの聖騎士	名詞	稀翁玉：マリーのテーマ
まいめいどすいーとめいど	"My Maid, Sweet Maid"	名詞	稀翁玉：エーリッヒのテーマ
おうかのこいづか	桜花之恋塚　～ Flower of Japan	名詞	稀翁玉：幽香のテーマ // [Japanese Flower] 蓬莱人形：Tr.03
おとめせんし	乙女戦士　～ Heart of Valkyrie	名詞	稀翁玉：モーガンのテーマ
えにぐまてぃくどーる	エニグマティクドール　～ God Knows	名詞	稀翁玉：ミューズのテーマ // 蓬莱人形：Tr.06
びろーどしょうじょせん	天鵞絨少女戦　～ Velvet Battle	名詞	稀翁玉：VIVITのテーマ
てんがじゅうしょうじょせん	天鵞絨少女戦　～ Velvet Battle	名詞	稀翁玉：VIVITのテーマ
きゃっするえくすぷろーらー	Castle Explorer -in the Sky-	名詞	稀翁玉：ゲイツのテーマ
かstぇえxpぉれr	Castle Explorer -in the Sky-	名詞	稀翁玉：ゲイツのテーマ
おるふぇのし	オルフェの詩　～ Pseudoclassic	名詞	稀翁玉：めい＆まいのテーマ
myまいdすぇえtまいd	"My Maid, Sweet Maid"	名詞	稀翁玉：エーリッヒのテーマ
まじかるあんどほーぷれす	Magical and Hopeless	名詞	トルテルマジック：シューのテーマ
せいくりっどばとる	Sacred Battle	名詞	トルテルマジック：コアントローのテーマ
まぎかぁんでょぺぇss	Magical and Hopeless	名詞	トルテルマジック：シューのテーマ
さcれdばttぇ	Sacred Battle	名詞	トルテルマジック：コアントローのテーマ
ようようばっこ	妖々跋扈　～ Speed Fox!	名詞	Cradle：Tr.17 / 東方妖々夢『博麗神社例大祭』スコアアタックBGM
60ねんめのとうほうさいばん	六十年目の東方裁判	名詞	紫香花：Tr.13 // [Fate of Sixty Years] 花映塚：四季映姫のテーマ
のんべぇのれむりあ	呑んべぇのレムリア	名詞	黄昏酒場：3面ボス・甘粕・バーレイ・天治のテーマ // [Retro Ver] 儚月抄(漫画版)上巻：Tr.03
あんおーでぃーるふろむごっど	AN ORDEAL FROM GOD	名詞	神魔討綺伝：5面テーマ
きゅありあすしゃんはいぐーぱい	キュアリアス上海古牌	名詞	東方幻想麻雀：ストーリーモード「香霖堂」卓3戦目のテーマ
しんまとうきでん	神魔討綺伝 AN ORDEAL FROM GOD	名詞	東方幻想麻雀：ストーリーモード「香霖堂」卓クリア後選択可能曲
ろくじゅうねんめのとうほうさいばん	六十年目の東方裁判	名詞	紫香花：Tr.13 // [Fate of Sixty Years] 花映塚：四季映姫のテーマ
あのrであlfろmごd	AN ORDEAL FROM GOD	名詞	神魔討綺伝：5面テーマ
きゅありあすしゃんはいこはい	キュアリアス上海古牌	名詞	東方幻想麻雀：ストーリーモード「香霖堂」卓3戦目のテーマ
あんおーでぃーるふろむごっど	神魔討綺伝 AN ORDEAL FROM GOD	名詞	東方幻想麻雀：ストーリーモード「香霖堂」卓クリア後選択可能曲
あのrであlfろmごd	神魔討綺伝 AN ORDEAL FROM GOD	名詞	東方幻想麻雀：ストーリーモード「香霖堂」卓クリア後選択可能曲
よいやみのまじゅつし	宵闇の魔術師	名詞	オリジナル
まじっくおぶらいふ	Magic of Life	名詞	オリジナル
ぷらすちっくすぺーす	Plastic Space	名詞	秋霜玉'99(秋霜玉プロトタイプ・99年度鳩山祭バージョン)：1面テーマ
いんべんてぃぶしてぃ	Inventive City	名詞	秋霜玉'99(秋霜玉プロトタイプ・99年度鳩山祭バージョン)：2面テーマ
むげんかいろう	夢幻回廊	名詞	オリジナル
ほうらいげんそう	蓬莱幻想　～ far East	名詞	秋霜玉：未使用曲(Extraテーマ)
まほうしょうじょじゅうじぐん	魔法少女十字軍　～ Little Little Crusader	名詞	秋霜玉：5面ボス・エーリッヒのテーマ(アレンジver) // 秋霜玉：5面ボス・エーリッヒのテーマ / 蓮台野夜行：Tr.09
よるのはとやまをとぶ	夜の鳩山を飛ぶ	名詞	Project Gian(秋霜玉プロトタイプ・98年度鳩山祭バージョン)BGM // [Power MIX] 求聞史紀：Tr.03
ふろんたるあたっく	Frontal Attack	名詞	秋霜玉'99(秋霜玉プロトタイプ・99年度鳩山祭バージョン)BGM(未公開)
せんりのみち	千里の道	名詞	midi練習曲 東方夢時空のエレンのテーマの原曲(未公開)
まぎこfぃふぇ	Magic of Life	名詞	オリジナル
pぁsちcsぱせ	Plastic Space	名詞	秋霜玉'99(秋霜玉プロトタイプ・99年度鳩山祭バージョン)：1面テーマ
いんゔぇんちゔぇしty	Inventive City	名詞	秋霜玉'99(秋霜玉プロトタイプ・99年度鳩山祭バージョン)：2面テーマ
fろんたぁったck	Frontal Attack	名詞	秋霜玉'99(秋霜玉プロトタイプ・99年度鳩山祭バージョン)BGM(未公開)
