ああそうかい	亜阿相界	名詞	
あか	紅	名詞	
あかいろ	紅色	名詞	
あみゅれっと	アミュレット	名詞	
ゔわる	ヴワル	名詞	
こいむすめ	恋娘	名詞	
こうま	紅魔	名詞	
こうろう	紅楼	名詞	
ごぎょうそうこく	五行相剋	名詞サ変	
ごぎょうそうせい	五行相生	名詞サ変	
そうこく	相剋	名詞サ変	
そうせい	相生	名詞サ変	
たいふーん	颱風	名詞	
つぇぺしゅ	ツェペシュ	人名	
でーもんろーど	デーモンロード	名詞	
とりうむほうかいけいれつ	トリウム崩壊系列	名詞	
ひょうせい	氷精	名詞	
よいやみ	宵闇	名詞	
ようま	妖魔	名詞	
るどびれ	ルドビレ	名詞	
れんれんおんがくかん	恋々音樂館	名詞	
あのよ	彼の世	名詞	
いいづな	飯綱	名詞	
いづな	飯綱	名詞	
えんりえど	厭離穢土	名詞	
おうか	桜花	名詞	
おうかけっかい	桜花結界	名詞	
おんりえど	厭離穢土	名詞	
かのよ	彼の世	名詞	
きょうがい	境界	名詞	
きょうちょう	凶兆	名詞	
ぐぁるねり	グァルネリ	人名	
くりふぉーど	クリフォード	人名	
けんかい	顕界	名詞	
げんかい	顕界	名詞	
げんそうきょうふどき	幻想郷風土記	名詞	
ごすい	五衰	名詞	
こちょう	胡蝶	名詞	
こっくり	狐狗狸	名詞	
ごほうてんどう	護法天童	名詞	
ごんぐじょうど	欣求浄土	名詞	
さいぎょうあやかし	西行妖	名詞	
さいぎょうよう	西行妖	名詞	
さくらてん	桜点	名詞	
しちょう	死蝶	名詞	
しゅ	呪	名詞	
しゅくざい	宿罪	名詞	
しゅんど	春度	名詞	
しょうじゃひつめつ	生者必滅	名詞	
しりょう	死霊	名詞	
しんらけっかい	森羅結界	名詞	
すとらでぃゔぁりうす	ストラディヴァリウス	人名	
すみぞめ	墨染	名詞	
せいめい	清明	名詞	
せーまん	清明	名詞	
そうれい	騒霊	名詞	
そうれいさんしまい	騒霊三姉妹	名詞	
だきにてん	荼吉尼天	名詞	
たねなしてじな	タネ無し手品	名詞	
ちべっと	西蔵	地名	
てぃあおいえつぉん	凋叶棕	名詞	
てんこ	天狐	名詞	
にんがい	人界	名詞	
はくろうけん	白楼剣	名詞	人間の迷いを断ち斬る事が出来る短剣。
はりみこ	針巫女	名詞	
はるど	春度	名詞	
はんごん	反魂	名詞	
はんにんはんりょう	半人半霊	名詞	
はんにんはんれい	半人半霊	名詞	
はんりょう	半霊	名詞	
はんれい	半霊	名詞	
ひろあり	広有	人名	
ふぁつぃおーり	ファツィオーリ	人名	
ふじみ	富士見	名詞	
べーぜんどるふぁー	ベーゼンドルファー	人名	
まよいが	迷い家	名詞	
みさまり	ミサマリ	名詞	
むかう	無何有	名詞	
むけんじごく	無間地獄	名詞	
むりょうごう	無量劫	名詞	
やまてん	夜摩天	名詞	
ゆじゅん	由旬	名詞	古代インドでの距離の一単位。1由旬＝約14.4km(9マイル)とも6.6kmとも。
ようちょう	妖蝶	名詞	
ようようおんがくしつ	妖々音樂室	名詞	
れざまり	レザマリ	名詞	
ろうかんけん	楼観剣	名詞	一振りで幽霊10匹分の殺傷力を持つ長刀。
いきぎも	生き肝	名詞	
いはかさ	いはかさ	名詞	
うごめ	蠢	動詞カ行五段	
えいや	永夜	名詞	
おうまがとき	逢魔が時	名詞	
おもいかね	八意思兼神	名詞	
おもいかね	思兼神	名詞	
かえで	槭樹	名詞	
かしょ	華胥	名詞	
きりつぶ	斬り潰	動詞サ行五段	
きんじゅ	禁呪	名詞	
ぐらんぎにょる	グランギニョル	名詞	
げつじん	月人	名詞	
こいいろ	恋色	名詞	
こくふ	刻符	名詞	
このはなのさくやびめ	木花之佐久夜毘売	名詞	
さんしゅのじんぎ	三種の神器	名詞	
しゅゆ	須臾	名詞	
じょふく	徐福	人名	
じんようてん	人妖点	名詞	
すずめが	天蛾	名詞	
ちじょうのみっしつ	地上の密室	名詞	
ちっきょ	蟄居	名詞	
つかいま	使い魔	名詞	
つきのいはかさ	月のいはかさ	人名	
つきのいはかさ	調岩笠	人名	
でぃぞるぶすぺる	ディゾルブスペル	名詞	
てんにん	天人	名詞	
とめどな	留処な	形容詞	
はく	魄	名詞	
はくたく	白沢	名詞	
はんじゅう	半獣	名詞	
ふじわらのふひと	藤原不比等	人名	
ふひと	不比等	人名	
ほうらい	蓬莱	名詞	
ほうらいじん	蓬莱人	名詞	
ほうらいのたまのえ	蓬莱の玉の枝	名詞	
ほうらいのたまのえだ	蓬莱の玉の枝	名詞	
ほうらいひと	蓬莱人	名詞	
ほうらいびと	蓬莱人	名詞	
ほたるび	蛍火	名詞	
ますぱ	マスパ	名詞	
まりすほう	マリス砲	名詞	
みみずく	木菟	名詞	
やすずめ	夜雀	名詞	
ゆうげん	幽玄	名詞	
ようりつ	妖率	名詞	
よすずめ	夜雀	名詞	
よひとよがくだん	夜一夜樂団	名詞	
らすとすぺる	ラストスペル	名詞	
りざれくしょん	リザレクション	名詞	
わーはくたく	ワーハクタク	名詞	
あつま	萃ま	動詞ラ行五段	
あつめ	萃め	動詞一段	
おにたいじ	鬼退治	名詞	
かろ	火炉	名詞	
しょうう	瘴雨	名詞	
すい	萃	名詞	
ねこいらず	猫イラズ	名詞	
ひとさらい	人攫い	名詞	
ひゃっきやこう	百鬼夜行	名詞	
かいかせんげん	開花宣言	名詞	
きこうおんがくしつ	季候音楽室	名詞	花映塚ミュージックルーム
きゅうれい	吸霊	名詞	
くるいざ	狂い咲	動詞カ行五段	
こみち	小径	名詞	
こんぱろ	コンパロ	名詞	
ごんべっさ	ゴンベッサ	名詞	
ざなどぅ	ザナドゥ	名詞	
さんせい	三精	名詞	
しがん	此岸	名詞	
しろいはた	素い幡	名詞	
すーさん	スーさん	名詞	
ぜんこう	善行	名詞サ変	
たいと	泰斗	名詞	
だんまくかいかせんげん	弾幕開花宣言	名詞	
でばがめ	デバガメ	名詞	
てんばく	纏縛	名詞	
はなのいへん	花の異変	名詞	
ふさ	鬱	動詞ガ行五段	
ぶんや	ブン屋	名詞	
まんじゅしゃげ	曼珠沙華	名詞	
むらくも	叢雲	名詞	
りりーぶらっく	リリーブラック	名詞	
ろうげつ	弄月	名詞	
あまてらす	天照大御神	名詞	
あまてらすおおみかみ	天照大御神	名詞	
いるめないと	イルメナイト	名詞	
えいじゃ	エイジャ	名詞	
えんのおづぬ	役小角	人名	
えんのおづの	役小角	人名	
おおなむち	大穴牟遅	名詞	
さんじぇるまん	サンジェルマン	名詞	
じゃくじょう	寂静	名詞	
しゅじょう	衆生	名詞	
じょうはり	浄頗梨	名詞	
ずいき	瑞亀	名詞	
せきせき	赤石	名詞	
ちゅうう	中有	名詞	
ちょうせいみついどう	超精密移動	名詞	
とんねるこうか	トンネル効果	名詞	
ひか	飛花	名詞	
ふうきょう	風狂	名詞形動	
ぶんきゅうのしらべ	文久の調べ ～Music Room	名詞	文花帖ミュージックルーム
みずのえのうらしまこ	瑞江浦嶋子	名詞	
みずのえのうらのしまこ	瑞江浦嶋子	名詞	
みずのえのうらのしまのこ	瑞江浦嶋子	名詞	
いといかわ	厭い川	名詞	
いといがわ	厭い川	名詞	
いなだひめ	稲田姫	名詞	
おおがねばば	大鐘婆	名詞	
おみわたり	御神渡り	名詞	
かくせい	客星	名詞	
かぜはふり	風祝	名詞	
きずあと	疵痕	名詞	
くしなだひめ	稲田姫	名詞	
けろちゃん	ケロちゃん	名詞	
こうがくめいさい	光学迷彩	名詞	
ごしんたい	御神体	名詞	
しんとく	神徳	名詞	
すいが	水眼	名詞	
すわたいしゃ	諏訪大社	名詞	
とぎょ	渡御	名詞	
どちゃくしん	土着神	名詞	
はふり	祝	名詞	
みしゃぐじさま	ミシャグジ様	名詞	
もりやいっか	守矢一家	名詞	
もりやじんじゃ	守矢神社	名詞	
やくがみ	厄神	名詞	
やくじん	厄神	名詞	
やちまた	八衢	名詞	
あたら	可惜	副詞	
あたらしんみょう	可惜身命	名詞	
おおむらのかみ	大村守	名詞	
おーろら	極光	名詞	
かいひけっかい	回避結界	名詞	
かなめいし	要石	名詞	
くしび	奇び	名詞形動	
こうかん	宏観	名詞	
こうかんぜんちょう	宏観前兆	名詞	
こんぎ	坤儀	名詞	
さよあらし	小夜嵐	名詞	
さるたひこ	猿田彦	名詞	
しきねんせんぐう	式年遷宮	名詞	
そうりょうむすめ	総領娘	名詞	
たちふうろ	立風露	名詞	
ちこ	地子	名	
てんきたま	天気玉	名詞	
てんきだま	天気玉	名詞	
なうぃ	名居	姓	
なうぃ	なゐ	名詞	
はなぐもり	花曇	名詞	
ひそうてん	非想天	名詞	
ひそうひひそうてん	非想非非想天	名詞	
ふしゃくしんみょう	不惜身命	名詞	
もけーれむべんべ	モケーレムベンベ	名詞	
よりまし	憑坐	名詞	
りゅうぎょ	龍魚	名詞	
りゅうぐうのつかい	リュウグウノツカイ	名詞	
りゅうぐうのつかい	龍宮の使い	名詞	
いけび	埋火	名詞	
うずみび	埋火	名詞	
かえんねこ	火焔猫	名詞	
かしゃ	火車	名詞	
こうしんきょうど	交信強度	名詞	
さぶたれいにあん	サブタレイニアン	名詞	
ざんきのかけら	残機の欠片	名詞	
じごくからす	地獄鴉	名詞	
じごくがらす	地獄鴉	名詞	
しゃくねつじごく	灼熱地獄	名詞	
しゃくねつじごくあと	灼熱地獄跡	名詞	
ちれい	地霊	名詞	
つちくも	土蜘蛛	名詞	
つちぐも	土蜘蛛	名詞	
つるべおとし	釣瓶落とし	名詞	
ねこぐるま	猫車	名詞	
はいごく	廃獄	名詞	
はしひめ	橋姫	名詞	
ほうかく	訪客	名詞	
やたがらす	八咫烏	名詞	
れいち	霊知	名詞	
からかさおばけ	からかさお化け	名詞	
せいれんせん	聖輦船	名詞	
とっこしょ	独鈷杵	名詞	
とびくら	飛倉	名詞	
とびくらのはへん	飛倉の破片	名詞	
なむさん	南無三	名詞	
びしゃもんてんのほうとう	毘沙門天の宝塔	名詞	
ひほう	飛宝	名詞	
ふくまでん	伏魔殿	名詞	
ふなゆうれい	舟幽霊	名詞	
べんとらー	ベントラー	名詞	
べんとらーあいてむ	ベントラーアイテム	名詞	
ほうじゅつ	法術	名詞	
ほうとう	宝塔	名詞	
ほうりき	法力	名詞	
ほうりょく	法力	名詞	
ほっかい	法界	名詞	
ぼむのかけら	ボムの欠片	名詞	
みょうれんじ	命蓮寺	名詞	
めいれんじ	命蓮寺	名詞	
ゆうよく	遊弋	名詞	
おおなまず	大ナマズ	名詞	
かんけつせんちかせんたー	間欠泉地下センター	名詞	
たいさいせいくん	太歳星君	名詞	
てんそく	天則	名詞	
みらいすいようばざー	未来水妖バザー	名詞	
かかしねんぽう	花果子念報	名詞	
たいこうしんぶん	対抗新聞	名詞	
あいすばりあ	アイスバリア	名詞	
だいしびょう	大祀廟	名詞	
きょでん	虚伝	名詞	
ごうかくきがん	合格祈願	名詞	
かないあんぜん	家内安全	名詞	
れんあいじょうじゅ	恋愛成就	名詞	
やくよけかいうん	厄除開運	名詞	
しょげいじょうたつ	諸芸上達	名詞	
びょうきへいゆ	病気平癒	名詞	
あんざんきがん	安産祈願	名詞	
じぎょうはんえい	事業繁栄	名詞	
しょううんこうじょう	勝運向上	名詞	
かちうんこうじょう	勝運向上	名詞	
りょこうあんぜん	旅行安全	名詞	
れいかいとらんす	霊界トランス	名詞	
れいかいげーじ	霊界ゲージ	名詞	
しょうしんれい	小神霊	名詞	
しんれい	神霊	名詞	
れいびょう	霊廟	名詞	
しんこうちゃーと	信仰チャート	名詞	
ぜんじどうれいはいどう	全自動礼拝堂	名詞	
にじげんぽけっと	二次元ポケット	名詞	
もしもさいせんぼっくす	もしも賽銭BOX	名詞	
こぴーぱぺっと	コピーパペット	名詞	
どこでもみずでっぽう	どこでも水鉄砲	名詞	
ぶれいくたいむふろしき	ブレイクタイムふろしき	名詞	
ようき	妖器	名詞	
ひとうばん	飛頭蛮	名詞	
るーがるー	ルーガルー	名詞	
さかさしろ	逆さ城	名詞	
あめのむらくものつるぎ	雨叢雲剣	名詞	
ようほうけん	陽宝剣	名詞	
ひげきり	髭切	名詞	
おにまるくにつな	鬼丸国綱	名詞	
どうじきりやすつな	童子切安綱	名詞	
ようとうむらまさ	妖刀村正	名詞	
はなざま	花狭間	名詞	
おかるとぼーる	オカルトボール	名詞	
ひがしふかみこうこう	東深見高校	名詞	
かんじゅ	紺珠	名詞	
きゅりおしてぃ	キュリオシティ	名詞	
いきなりだんご	いきなり団子	名詞	
りょくしゅでん	緑珠伝	名詞	
いーぐるらう゛ぃ	イーグルラヴィ	名詞	
ぱんでもにっく	パンデモニック	名詞	
つきびと	月人	名詞	
ぐもんじ	求聞持	名詞	
ぐもんじののうりょく	求聞持の能力	名詞	阿求(御阿礼の子)の能力
みあれ	御阿礼	名詞	
みあれのこ	御阿礼の子	名詞	
ようがく	幺樂	名詞	
ようがくだん	幺樂団	名詞	
あれおとめ	阿礼乙女	名詞	
あれ	阿礼	人名	
あいち	阿一	人名	
あに	阿爾	人名	
あみ	阿未	人名	
あよ	阿余	人名	
あご	阿悟	人名	
あむ	阿夢	人名	
あしち	阿七	人名	
あや	阿弥	人名	
あ0	阿礼	人名	
あ1	阿一	人名	
あ2	阿爾	人名	
あ3	阿未	人名	
あ4	阿余	人名	
あ5	阿悟	人名	
あ6	阿夢	人名	
あ7	阿七	人名	
あ8	阿弥	人名	
あ9	阿求	人名	
こうむいへん	紅霧異変	名詞	
しゅんせついへん	春雪異変	名詞	
えいやいへん	永夜異変	名詞	
ろくじゅうねんしゅうきのだいけっかいいへん	六十年周期の大結界異変	名詞	
60ねんしゅうきのだいけっかいいへん	六十年周期の大結界異変	名詞	
きゅうけつきいへん	吸血鬼異変	名詞	
げんそうげつめんせんそう	幻想月面戦争	名詞	
ようかいかくちょうけいかく	妖怪拡張計画	名詞	
だいけっかいそうどう	大結界騒動	名詞	
ゆうれいそうどう	幽霊騒動	名詞	
ゆうれいいみんけいかく	幽霊移民計画	名詞	
しゃちゅう	捨虫	名詞	
しゃしょく	捨食	名詞	
ようじゅう	妖獣	名詞	
じゅうじん	獣人	名詞	
てんま	天魔	名詞	
だいてんぐ	大天狗	名詞	
からすてんぐ	鴉天狗	名詞	
はなだかてんぐ	鼻高天狗	名詞	
はくろうてんぐ	白狼天狗	名詞	
やまぶしてんぐ	山伏天狗	名詞	
りゅうじんのせきぞう	竜神の石像	名詞	
つくもしん	付喪神	名詞	
つくもがみ	付喪神	名詞	
ぜひきょくちょくちょう	是非曲直庁	名詞	
じょうはり	浄玻璃	名詞	
じょうはりのかがみ	浄玻璃の鏡	名詞	
かいごのぼう	悔悟の棒	名詞	
きりさめまほうてん	霧雨魔法店	名詞	
くじゅ	口授	名詞	
ちょうじゅうぎがく	鳥獣伎楽	名詞	
ぶんぶんまる	文々。	名詞	
ぶんぶんまるしんぶん	文々。新聞	名詞	
げっとばんしょうてん	月都万象展	名詞	
げつとばんしょうてん	月都万象展	名詞	
こちょうむがん	胡蝶夢丸	名詞	
さかさにじ	逆さ虹	名詞	
とかくどうめい	兎角同盟	名詞	
むしのしらせ	蟲の知らせ	名詞	
むしのしらせさーびす	蟲の知らせサービス	名詞	
やきやつめうなぎ	焼き八目鰻	名詞	
やつめうなぎ	八目鰻	名詞	
わらにんぎょう	藁人形	名詞	
ひかりのさんようせい	光の三妖精	名詞	
さんようせい	三妖精	名詞	
あまてらすおおみかみ	天照大神	名詞	
あまのかがせおのみこと	天香香背男命	名詞	
いくち	黄蕈	名詞	
うそかえしんじ	鷽替神事	名詞	
かみまい	紙舞	名詞	
かやのひめ	萱野姫	名詞	
けいよう	剄妖	名詞	
さえのかみ	塞の神	名詞	
しゅちゅう	酒虫	名詞	
たかくさごおり	高草郡	名詞	
ちゅうじょうせつり	柱状節理	名詞	
つちのこ	槌の子	名詞	
のづち	野槌	名詞	
はるつげせい	春告精	名詞	
ひかりごけ	光苔	名詞	
ひふう	秘封	名詞	
ひふうくらぶ	秘封倶楽部	名詞	
かみかくし	神隠し	名詞	
かれいどすくりーん	カレイドスクリーン	名詞	
きょうていせかいじ	協定世界時	名詞	
けいと	繋都	名詞	
けっかいけつ	結界穴	名詞	
じんき	神亀	名詞	
そうたいせいせいしんがく	相対性精神学	名詞	
ちょうとういつぶつりがく	超統一物理学	名詞	
でんでらの	デンデラ野	地名	
ねんしゃ	念写	名詞	
ぼうとうきょう	卯東京	名詞	
ぼうゆう	卯酉	名詞	
ゆうきょうと	酉京都	名詞	
ようちょう	妖鳥	名詞	
れいと	霊都	名詞	
れんだいの	蓮台野	地名	
わらべまつり	童祭	名詞	
わらわまつり	童祭	名詞	
あまつみかほし	天津甕星	名詞	
あまのいわとわけのみこと	天石門別命	名詞	
あめのうずめのみこと	天宇受売命	名詞	
いしこりどめのみこと	石凝姥命	名詞	
いづのめ	伊豆能売	名詞	
いわながひめ	石長姫	名詞	
うわつつのおのみこと	上筒男命	名詞	
おおくにぬしのみこと	大国主命	名詞	
おおまがつみ	大禍津日	名詞	
かなやまひこのみこと	金山彦命	名詞	
ぎょくと	玉兎	名詞	
げつめんせんそう	月面戦争	名詞	
ごき	後鬼	名詞	
すみよしけいかく	住吉計画	名詞	
すみよしけいかく	住吉月面侵略計画	名詞	
すみよしげつめんしんりゃくけいかく	住吉月面侵略計画	名詞	
すみよしさんしん	住吉三神	名詞	
ぜんき	前鬼	名詞	
せんじゃふだ	千社札	名詞	
そこつつのおのみこと	底筒男命	名詞	
たけみなかた	建御名方	名詞	
たまくしげ	玉匣	名詞	
つきのはごろも	月の羽衣	名詞	
なかつつのおのみこと	中筒男命	名詞	
ふぇむと	フェムト	名詞	
ふぇむとふぁいばー	フェムトファイバー	名詞	
ぷろじぇくとすみよし	住吉月面侵略計画	名詞	
ぼう	儚	名詞	
ぼうげつ	儚月	名詞	
ほのいかづちのかみ	火雷神	名詞	
ももやそはしら	百八十柱	名詞	
やたのかがみ	八咫鏡	名詞	
やつがたけ	八ヶ岳	名詞	
れいげつさい	例月祭	名詞	
りん	霖	名詞	
ながあめ	霖	名詞	
はっけろ	八卦炉	名詞	
みにはっけろ	ミニ八卦炉	名詞	
いばらきどうじ	茨木童子	名詞	
ゆうかく	有角	名詞	
らいじゅう	雷獣	名詞	
びぶろふぃりあ	ビブロフィリア	名詞	本(書籍)に対する愛を発露する人のこと。愛書家。
しゃーまん	シャーマン	名詞	
まじしゃん	マジシャン	名詞	
さゔぁん	サヴァン	名詞	
でぃすがいざー	ディスガイザー	名詞	
ようまぼん	妖魔本	名詞	
あやかし	妖	名詞	
おふだ	御札	名詞	
おんみょうぎょく	陰陽玉	名詞	
けっかい	結界	名詞	
しきがみ	式神	名詞	
しきじん	式神	名詞	
しょうじょだんまくきたん	少女弾幕奇譚	名詞	
しょうじょだんまくしゅーてぃんぐ	少女弾幕シューティング	名詞	
じんがい	人外	名詞	
じんよう	人妖	名詞	
すぺるかーどるーる	命名決闘法案	名詞	
ずんぼう	ZUN帽	名詞	
だんまくごっこ	弾幕ごっこ	名詞	
まりょく	魔力	名詞	
めいめいけっとうほうあん	命名決闘法案	名詞	
ようき	妖気	名詞	
ようじゅつ	妖術	名詞	
ようむ	妖霧	名詞	
ようりょく	妖力	名詞	
れいき	霊気	名詞	
れいりょく	霊力	名詞	
わきみこ	腋巫女	名詞	
うちょうてん	有頂天	地名	
えいえんてい	永遠亭	名詞	
おおがまのいけ	大蝦蟇の池	地名	
きりのみずうみ	霧の湖	地名	
げんぶのさわ	玄武の沢	地名	
げんうんかい	玄雲海	地名	
げんそうきょう	幻想郷	地名	
げんそうげん	幻草原	地名	
こうまかん	紅魔館	名詞	
さいしのみち	再思の道	地名	
さんずのかわ	三途の河	地名	
たいようのはたけ	太陽の畑	地名	
ちゅううのみち	中有の道	地名	
つきのみやこ	月の都	地名	
にんげんのさと	人間の里	地名	
はくぎょくろう	白玉楼	名詞	
はくれいじんじゃ	博麗神社	名詞	
はくれいだいけっかい	博麗大結界	名詞	
ひがん	彼岸	地名	
まほうのもり	魔法の森	地名	
まよいのちくりん	迷いの竹林	地名	
むえんづか	無縁塚	地名	
むげんいせき	夢幻遺跡	名詞	
むげんかん	夢幻館	名詞	
むめいのおか	無名の丘	地名	
めいかい	冥界	地名	
ようかいのやま	妖怪の山	地名	
ゆうめいけっかい	幽冥結界	名詞	
ようかいけものみち	妖怪獣道	地名	
きゅうじごく	旧地獄	地名	
ゆめどのたいしびょう	夢殿大祀廟	名詞	
ゆめどの	夢殿	名詞	
たいしびょう	大祀廟	名詞	
しんれいびょう	神霊廟	名詞	
すずなあん	鈴奈庵	名詞	
うんじょうのたからぶね	雲上の宝船	名詞	
ようかいだぬきのもり	妖怪狸の森	名詞	
ようかいのさんろく	妖怪の山麓	地名	
ようかいのやまのみずうみ	妖怪の山の湖	地名	
ひみつのれんらくつうろ	秘密の連絡通路	地名	
しずかのうみ	静かの海	地名	
しずかのうみ	静かの海（裏）	地名	
ゆめのせかい	夢の世界	地名	
あたりはんてい	当たり判定	名詞	
あんち	安地	名詞	
うそよけ	嘘避け	名詞	
うろこだん	鱗弾	名詞	
えくすてんど	エクステンド	名詞	
かかえおち	抱え落ち	名詞	
かす	カス	動詞ラ行五段	
きすうだん	奇数弾	名詞	
ぐうすうだん	偶数弾	名詞	
くさびだん	楔弾	名詞	
くないだん	クナイ弾	名詞	
くらいぼむ	喰らいボム	名詞サ変	
ぐれいず	Graze	名詞サ変	
ぐれいず	グレイズ	名詞サ変	
けっしけっかい	決死結界	名詞	
こうそくいどう	高速移動	名詞サ変	
こていだん	固定弾	名詞	
こめだん	米弾	名詞	
こめつぶだん	米粒弾	名詞	
ざやくだん	坐薬弾	名詞	
ざんき	残機	名詞	
じき	自機	名詞	
じきねらい	自機狙い	名詞	
しょりおち	処理落ち	名詞サ変	
すぺか	スペカ	名詞	
すぺるかーど	スペルカード	名詞	
ぜんほういだん	全方位弾	名詞	
たいきゅうだんまく	耐久弾幕	名詞	
たいけんばん	体験版	名詞	
だえんだん	楕円弾	名詞	
たまけし	弾消し	名詞サ変	
だんそく	弾速	名詞	
だんまく	弾幕	名詞	
だんまくしゅーてぃんぐ	弾幕STG	名詞	
だんまくしゅーてぃんぐ	弾幕シューティング	名詞	
ちきんぼむ	チキンボム	名詞サ変	
ちゅうだま	中玉	名詞	
ちゅうだん	中弾	名詞	
ちゅうぼす	中ボス	名詞	
ちょうだん	蝶弾	名詞	
ちょんよけ	チョン避け	名詞サ変	
ていそくいどう	低速移動	名詞サ変	
てんだん	点弾	名詞	
ないふだん	ナイフ弾	名詞	
ばらまきだん	ばら撒き弾	名詞	
ぴちゅ	ピチュ	動詞ラ行五段	
びびりぼむ	びびりボム	名詞	
へにょりれーざー	へにょりレーザー	名詞	
ほしがただん	星型弾	名詞	
ほしだん	星弾	名詞	
らんだむだん	ランダム弾	名詞	
りんぐだん	リング弾	名詞	
はくれいじんじゃれいたいさい	博麗神社例大祭	名詞	
れいたいさい	例大祭	名詞	
とうほうこうろうむ	東方紅楼夢	名詞	
こうろうむ	紅楼夢	名詞	
だいきゅうしゅうとうほうさい	第⑨州東方祭	名詞	
だいきゅうしゅう	第⑨州	名詞	
とうほうめいかさい	東方名華祭	名詞	
めいかさい	名華祭	名詞	
とうほうけんぶんろく	東方絢文禄	名詞	
けんぶんろく	絢文禄	名詞	
とうほうかむいさい	東方神居祭	名詞	
かむいさい	神居祭	名詞	
とうほうやりんさい	東方椰麟祭	名詞	
やりんさい	椰麟祭	名詞	
