あうたーいぐじすたんす	Outer Existance	名詞	
あおのなつき	青野菜月	名詞	
あかしっくれこーど	アカシックレコード	名詞	
あかり	月	名詞	
あのひのやくそく	あの日の約束	名詞	
あやめ	彩芽	名詞	
あんぷらぐ	UNPLUG	名詞	
あんり	杏梨	名詞	
いのせんと	INNOCENT	名詞	
いんふぃにっと	INFINIT3!!	名詞	
うらら	U・RA・RA	名詞	
えいとびーとすとーりー	8beatStory	名詞	
えくすたしー	Ecstasy	名詞	
えびすと	エビスト	名詞	
えらー	Error	名詞	
おーばーどらいぶ	オーバードライブ	名詞	
おとめでないと	おとめ☆de☆Night	名詞	
かうんといっとだうん	Count it Down	名詞	
かぐらあかり	神楽月	名詞	
かなえるみらい	カナエルミライ	名詞	
きずなのぽらりす	絆のポラリス	名詞	
ぎぶみーらぶ	Give Me Love	名詞	
きみはれもねーど	君はレモネード	名詞	
きんぎょわかな	金魚わかな	名詞	
げんじほたる	源氏ほたる	名詞	
げんじものがたり	源氏物語	名詞	
ごーらいぶ	Go Live!!	名詞	
こが	虎牙	名詞	
こがあるみ	虎牙アルミ	名詞	
こがみんと	虎牙ミント	名詞	
ここから	ここから	名詞	
さくらぎひなた	桜木ひなた	名詞	
さくらなみだ	サクラ涙	名詞	
さわだみはる	澤田美晴	名詞	
しゃいにー	Shiny	名詞	
しゃもと	社本	名詞	
しゃもとはるか	社本悠	名詞	
しゅがーしゅがーびー	Sugar SugarBee	名詞	
しらとりろくされーぬけいこ	白鳥ロクサレーヌ慶子	名詞	
すくーるでぃすこ	スクールディスコ	名詞	
すてぃる	Still...	名詞	
せんてひっしょうすまいる	先手必勝スマイル	名詞	
ぜんぶきみのために	全部、君のために	名詞	
そらのかなで	空乃かなで	名詞	
それゆけおとめのみっしょん	それゆけ!!乙女のミッション!	名詞	
たいにーりとるれたー	Tiny little letter	名詞	
だいぶいんざふゅーちゃー	Dive in the Future	名詞	
たちばなあやめ	橘彩芽	名詞	
つゔぁい	2_wEi	名詞	
でいず	Days	名詞	
でぃすたんす	Distance	名詞	
ですぴあー	Despair	名詞	
とぅうぃんくるすのう	Twinkle Snow	名詞	
ときめきのじゅうごせんち	トキメキの15センチ	名詞	
どりーまー	DREAMER	名詞	
とわえもえ	Toi et Moi	名詞	
はつこいちぇりーぶろっさむ	初恋チェリーブロッサム	名詞	
はにーぷらねっと	8/pLanet!!	名詞	
はにぷら	ハニプラ	名詞	
はぴめり	ハピ♡メリ	名詞	
はるか	悠	名詞	
はろうぃーんないと	Halloween☆Night	名詞	
ひすとりー	History	名詞	
ひみつのへやのおんなのこ	秘密の部屋の女の子	名詞	
ひめさきあんり	姫咲杏梨	名詞	
ふぁじーんうぉんきー	Fuzzy N' Wonky	名詞	
ふぁんたじあ	ファンタジア	名詞	
ふらっふぃーばるーん	Fluffy Balloon	名詞	
ぶるーむーん	BLUE MOON	名詞	
ふわりあるたいむ	ふわりあるたいむ	名詞	
ぼーいふれんど	BoyFriend	名詞	
ほしみやゆきな	星宮ゆきな	名詞	
ほんとのきもち	ホントの気持ち	名詞	
まいなす	Minus	名詞	
みかづきどりーむ	三日月どりーむ	名詞	
みなせすずね	水瀬鈴音	名詞	
めい	メイ	名詞	
よしいあやみ	吉井彩実	名詞	
よしおかみさき	吉岡美咲	名詞	
よしむらななみ	吉村那奈美	名詞	
らぶりーさまー	Lovely Summer	名詞	
りめんばー	Remenber	名詞	
るーてぃんぐふぉーゆー	Rooting for You	名詞	
ろすといんでーた	Lost in data	名詞	
わきあずみ	和氣あず未	名詞	
