Awoke	AWOKE	名詞	
Dearmyfuture	Dear my future	名詞	
Deepness	DEEPNESS	名詞	
Dreambelievers	Dream Believers	名詞	
Feslive	Fes×LIVE	名詞	
Holidayholiday	Holiday∞Holiday	名詞	
Kawaiinosusume	Kawaii no susume	名詞	
Knot	KNOT	名詞	
Legato	Legato	名詞	
Linktothefuture	Link to the FUTURE	名詞	
Miragevoyage	Mirage Voyage	名詞	
Mixshake	Mix shake!!	名詞	
Onyourmark	On your mark	名詞	
Reflectioninthemirror	Reflection in the mirror	名詞	
Sparklyspot	Sparkly Spot	名詞	
Takeitover	Take It Over	名詞	
Tragicdrops	Tragic Drops	名詞	
Trickandcute	Trick ＆ Cute	名詞	
Withmeets	With×MEETS	名詞	
Yupyupyup	Yup! Yup! Yup!	名詞	
あいでんてぃてぃ	アイデンティティ	名詞	
あうぉーく	AWOKE	名詞	
あすのそらのぼくたちへ	明日の空の僕たちへ	名詞	
あめいろ	飴色	名詞	
うぃずみーつ	With×MEETS	名詞	
えいえんのゆーとぴあ	永遠のEuphoria	名詞	
えな	えな	名詞	
おうからんまん	謳歌爛漫	名詞	
おおがみさち	大賀美 沙知	名詞	
おおさわるりの	大沢 瑠璃乃	名詞	
おとむねこずえ	乙宗 梢	名詞	
おんゆあまーく	On your mark	名詞	
かほ	花帆	名詞	
かわいいのすすめ	Kawaii no susume	名詞	
かんかんこなちのみらくらたいきしつらじお	かんかん＆こなちのみらくら待機室ラジオ	名詞	
かんかんこなちのみらくらほしゅうしつらじお	かんかん＆こなちのみらくら補習室ラジオ	名詞	
かんかんな	菅叶和	名詞	
きぼうてきぷりずむ	希望的プリズム	名詞	
げんようやこう	眩耀夜行	名詞	
ここんとうざい	ココン東西	名詞	
こずえ	梢	名詞	
ささきことこ	佐々木琴子	名詞	
ざんよう	残陽	名詞	
しいな	しいな	名詞	
じぶんだいありー	ジブンダイアリー	名詞	
しゅがーめると	シュガーメルト	名詞	
すいさいせかい	水彩世界	名詞	
すがおのぴくせる	素顔のピクセル	名詞	
すくーるあいどるこねくと	スクールアイドルコネクト	名詞	
すくーるあいどるすてーじ	スクールアイドルステージ	名詞	
すくすて	スクステ	名詞	
すけーぷごーと	スケイプゴート	名詞	
すぱーくりーすぽっと	Sparkly Spot	名詞	
すりーずぶーけ	スリーズブーケ	名詞	
せいしゅんのりんかく	青春の輪郭	名詞	
せーのではすのそら	せーので！はすのそら	名詞	
せんぺんばんか	千変万華	名詞	
つきねこな	月音こな	名詞	
つきまかせ	ツキマカセ	名詞	
つづり	綴理	名詞	
つばさらりべるて	ツバサ・ラ・リベルテ	名詞	
でぃあまいふゅーちゃー	Dear my future	名詞	
でぃーぷねす	DEEPNESS	名詞	
ていくいっとおーばー	Take It Over	名詞	
てんさいなのかもしれない	天才なのかもしれない	名詞	
どどど	ド！ド！ド！	名詞	
とらじっくどろっぷす	Tragic Drops	名詞	
どりーむびりーばーず	Dream Believers	名詞	
とりっくあんどきゅーと	Trick ＆ Cute	名詞	
どるけすとら	DOLLCHESTRA	名詞	
なつめきぺいん	夏めきペイン	名詞	
にれいのぞみ	楡井希実	名詞	
のっと	KNOT	名詞	
のなかここな	野中ここな	名詞	
のんふぃくしょんひーろー	ノンフィクションヒーローショー	名詞	
はくちゅーあらもーど	ハクチューアラモード	名詞	
はすのそら	蓮ノ空	名詞	
はすのそらじょがいくいんすくーるあいどるくらぶ	蓮ノ空女学院スクールアイドルクラブ	名詞	
はすのそらじょがくいん	蓮ノ空女学院	名詞	
はすのそらのことすきすきくらぶのみなさん	蓮ノ空のこと好き好きクラブの皆さん	名詞	
はなみやにいな	花宮初奈	名詞	
ぱられるだんさー	パラレルダンサー	名詞	
ひのしたかほ	日野下 花帆	名詞	
びわこ	びわこ	名詞	
ふぇすらいぶ	Fes×LIVE	名詞	
ふぉーちゅんむーびー	フォーチュンムービー	名詞	
ふじしまめぐみ	藤島 慈	名詞	
ほりでぃほりでぃ	Holiday∞Holiday	名詞	
みっくすしぇいく	Mix shake!!	名詞	
みらーじゅぼやーじゅ	Mirage Voyage	名詞	
みらくらぱーく	みらくらぱーく！	名詞	
むらのさやか	村野 さやか	名詞	
めぐみ	慈	名詞	
やっぷやっぷやっぷ	Yup! Yup! Yup!	名詞	
ゆうぎりつづり	夕霧 綴理	名詞	
らいぐら	ライグラ	名詞	
らいぶぐらんぷり	ライブグランプリ	名詞	
りふれくしょんいんざみらー	Reflection in the mirror	名詞	
りんくとぅざふゅーちゃー	Link to the FUTURE	名詞	
りんくら	リンクラ	名詞	
りんくらいくらぶらいぶ	Link!Like!ラブライブ!	名詞	
るりの	瑠璃乃	名詞	
れがーと	Legato	名詞	
すりぶ	スリブ	名詞	
どるけ	ドルケ	名詞	
みらぱ	みらぱ	名詞	
はす	🪷	名詞	
かほめぐじぇらーと	かほめぐ♡じぇら～と	名詞	
るりのとゆかいなつづりたち	るりのとゆかいなつづりたち	名詞	
はすのきゅうじつ	蓮ノ休日	名詞	
