らぶらいぶ	ラブライブ！	名詞	
らぶらいぶ	LoveLive!	名詞	
すくふぇす	スクールアイドルフェスティバル	名詞	
でんげきじーずまがじん	電撃G's magazine	名詞	
でんげきじーずこみっく	電撃G'sコミック	名詞	
Sid	School idol diary	名詞	
らぶらいぶ!ざすくーるあいどるむーびー	ラブライブ！The School Idol Movie	名詞	
らぶらいぶ!さんしゃいん	ラブライブ！ サンシャイン!!	名詞	
のぞえりらじおがーでん	のぞえりRadioGarden	名詞	
にこりんぱな	ラブライ部 μ's広報部 〜にこりんぱな〜	名詞	
らじおがーでん	RadioGarden	名詞	
らぶらいばー	ラブライバー	名詞	
らぶらいぶいん	ラブライ部員	名詞	
おとのきざかがくいん	音ノ木坂学院	名詞	
おとのき	音ノ木	名詞	
ほむら	穂むら	名詞	
みゅーず	μ's	名詞	
ぷらんたん	Printemps	名詞	
びび	BiBi	名詞	
りりーほわいと	lily white	名詞	
UTXがくいん	UTX学院	名詞	
UTXがくえん	UTX学園	名詞	
あらいず	A-RISE	名詞	
こうさかほのか	高坂穂乃果	人名	
ほのか	穂乃果	名	
あやせえり	絢瀬絵里	人名	
あやせ	絢瀬	姓	
みなみことり	南ことり	人名	
そのだうみ	園田海未	人名	
うみ	海未	名	
ほしぞらりん	星空凛	人名	
にしきのまき	西木野真姫	人名	
にしきの	西木野	姓	
まき	真姫	名	
とうじょうのぞみ	東條希	人名	
こいずみはなよ	小泉花陽	人名	
はなよ	花陽	名	
やざわにこ	矢澤にこ	人名	
にったえみ	新田恵海	人名	
なんじょうよしの	南條愛乃	人名	
うちだあや	内田彩	人名	
みもりすずこ	三森すずこ	人名	
いいだりほ	飯田里穂	人名	
ぱいる	Pile	人名	
くすだあいな	楠田亜衣奈	人名	
くぼゆりか	久保ユリカ	人名	
とくいそら	徳井青空	人名	
きらつばさ	綺羅ツバサ	人名	
とうどうえれな	統堂英玲奈	人名	
とうどう	統堂	姓	
えれな	英玲奈	名	
ゆうきあんじゅ	優木あんじゅ	人名	
ゆうき	優木	姓	
こうさかゆきほ	高坂雪穂	人名	
ゆきほ	雪穂	名	
あやせありさ	絢瀬亜里沙	人名	
ありさ	亜里沙	名	
やざわこころ	矢澤こころ	人名	
やざわここあ	矢澤ここあ	人名	
やざわこたろう	矢澤虎太郎	人名	
こたろう	虎太郎	名	
やまだひろこ	山田 博子	人名	
ひでこ	ヒデコ	人名	
ふみこ	フミコ	人名	
みか	ミカ	人名	
ぼくらのらいぶきみとのらいふ	僕らのLIVE 君とのLIFE	名詞	
ゆうじょうのーちぇんじ	友情ノーチェンジ	名詞	
すのーはれーしょん	Snow halation	名詞	
べいびーめいびーこいのぼたん	baby maybe 恋のボタン	名詞	
らぶまーじなる	Love marginal	名詞	
すいーとあんどすいーとほりでい	sweet&sweet holiday	名詞	
だいやもんどぷりんせすのゆううつ	ダイヤモンドプリンセスの憂鬱	名詞	
らぶのべるす	ラブノベルス	名詞	
しらないらぶおしえてらぶ	知らないLove*教えてLove	名詞	
あのねがんばれ	あ・の・ね・が・ん・ば・れ！	名詞	
なついろえがおでわんつーじゃんぷ	夏色えがおで1,2,Jump!	名詞	
まーめいどふぇすたぼりゅーむわん	Mermaid festa vol.1	名詞	
わたしたちはみらいのはな	私たちは未来の花	名詞	
すぴかてりぶる	スピカテリブル	名詞	
あいはたいようじゃない	愛は太陽じゃない？	名詞	
もうひとりじゃないよ	もうひとりじゃないよ	名詞	
まーめいどふぇすたぼりゅーむ1	Mermaid festa vol.1	名詞	
もぎゅっとらぶでせっきんちゅう	もぎゅっと“love”で接近中！	名詞	
あいしてるばんざーい	愛してるばんざーい！	名詞	
まーめいどふぇすたぼりゅーむつーぱしょねーと	Mermaid festa vol.2 〜Passionate〜	名詞	
まーめいどふぇすたぼりゅーむ2ぱしょねーと	Mermaid festa vol.2 〜Passionate〜	名詞	
さむでいおぶまいらいふ	Someday of my life	名詞	
こいのしぐなるりんりんりん	恋のシグナル Rin rin rin!	名詞	
おとめしきれんあいじゅく	乙女式れんあい塾	名詞	
まほうつかいはじめました	まほうつかいはじめました！	名詞	
じゅんあいれんず	純愛レンズ	名詞	
こくはくびよりです	告白日和、です！	名詞	
ぶるーべりーとれいん	ぶる〜べりぃ♥とれいん	名詞	
こどくなへぶん	孤独なHeaven	名詞	
そるじゃーげーむ	soldier game	名詞	
だーりん	Daring!!	名詞	
ゆうきのりーずん	勇気のReason	名詞	
ありふれたかなしみのはて	ありふれた悲しみの果て	名詞	
わんだふるらっしゅ	Wonderful Rush	名詞	
おーらぶあんどぴーす	Oh,Love&Peace!	名詞	
りっすんとぅまいはーと	Listen to my heart!!	名詞	
あふたーすくーるなびげーたー	after school NAVIGATORS	名詞	
ぼくらはいまのなかで	僕らは今のなかで	名詞	
わいるどすたーず	WILD STARS	名詞	
きっとせいしゅんがきこえる	きっと青春が聞こえる	名詞	
かぐやのしろでおどりたい	輝夜の城で踊りたい	名詞	
すすめとぅもろう	ススメ→トゥモロウ	名詞	
すたーとだっしゅ	START:DASH!!	名詞	
これからのさむでい	これからのSomeday	名詞	
わんだーぞーん	Wonder zone	名詞	
ゆめなきゆめはゆめじゃない	夢なき夢は夢じゃない	名詞	
ぷらいべーとうぉーず	Private Wars	名詞	
のーぶらんどがーるず	No brand girls	名詞	
あねもねはーと	Anemone heart	名詞	
なわとび	なわとび	名詞	
びーといんえんじぇる	Beat in Angel	名詞	
びねつからみすてりー	微熱からMystery	名詞	
きみのくせに	キミのくせに！	名詞	
きゅーてぃぱんさー	Cutie Panther	名詞	
なつおわらないで	夏、終わらないで。	名詞	
にこぷりじょしどう	にこぷり女子道	名詞	
ぴゅあがーるずぷろじぇくと	Pure girls project	名詞	
あんばらんすどらぶ	UNBALANCED LOVE	名詞	
がらすのはなぞの	硝子の花園	名詞	
ろんりえすとべいびー	LONELIEST BABY	名詞	
ぷわぷわーお	ぷわぷわーお！	名詞	
みゅーじっくすたーと	Music S.T.A.R.T!!	名詞	
らぶれすわーるど	LOVELESS WORLD	名詞	
たからものず	タカラモノズ	名詞	
ぱらだいすらいぶ	Paradise Live	名詞	
えんどれーすぱれーど	ENDLESS PARADE	名詞	
それはぼくたちのきせき	それは僕たちの奇跡	名詞	
だってだってああむじょう	だってだって噫無情	名詞	
どんなときもずっと	どんなときもずっと	名詞	
からふるぼいす	COLORFUL VOICE	名詞	
ゆめのとびら	ユメノトビラ	名詞	
せんちめんたるすてっぷす	SENTIMENTAL StepS	名詞	
らぶうぃんぐべる	Love wing bell	名詞	
だんしんぐすたーずおんみー	Dancing stars on me!	名詞	
しあわせいきのすまいりんぐ	シアワセ行きのSMILING!	名詞	
きらきらせんせーしょん	KiRa-KiRa Sensation!	名詞	
はっぴーめいかー	Happy maker!	名詞	
ずるいよまぐねてぃっくとぅでい	ずるいよMagnetic today	名詞	
くるりんみらくる	くるりんMIRACLE	名詞	
しゃんぐりらしゃわー	Shangri-La Shower	名詞	
るてしきすきしてる	るてしキスキしてる	名詞	
すとーむいんらばー	Storm in Lover	名詞	
もしもからきっと	もしもからきっと	名詞	
えいえんふれんず	永遠フレンズ	名詞	
ないちんげーるらぶそんぐ	小夜啼鳥恋詩	名詞	
すきですがすきですか	好きですが好きですか？	名詞	
あきのあなたのそらとおく	秋のあなたの空遠く	名詞	
ふたりはぴねす	ふたりハピネス	名詞	
ふゆがくれたよかん	冬がくれた予感	名詞	
とらぶるばすたーず	Trouble Busters	名詞	
そしてさいごのぺーじには	そして最後のページには	名詞	
ちあでいちあがーる	CheerDay CheerGirl!	名詞	
さいれんととぅないと	silent tonight	名詞	
おなじほしがみたい	同じ星が見たい	名詞	
ぼくたちはひとつのひかり	僕たちはひとつの光	名詞	
えんじぇりっくえんじぇる	Angelic Angel	名詞	
さにーでいそんぐ	SUNNY DAY SONG	名詞	
はろーほしをかぞえて	Hello,星を数えて	名詞	
はてなはーとびーと	？←HEARTBEAT	名詞	
ふゅーちゃーすたいる	Future Style	名詞	
＠ぼららら	僕らのLIVE 君とのLIFE	名詞	
のーちぇん	ノーチェン	名詞	
＠のーちぇん	友情ノーチェンジ	名詞	
すのはれ	スノハレ	名詞	
＠すのはれ	Snow halation	名詞	
こいぼた	恋ボタ	名詞	
＠こいぼた	baby maybe 恋のボタン	名詞	
らぶまじ	ラブマジ	名詞	
＠らぶまじ	Love marginal	名詞	
＠ssh	sweet&sweet holiday	名詞	
だいぷり	ダイプリ
＠だいぷり	ダイヤモンドプリンセスの憂鬱	名詞	
らぶのべ	ラブノベ	名詞	
＠らぶのべ	ラブノベルス	名詞	
＠しららら	知らないLove*教えてLove	名詞	
＠あのね	あ・の・ね・が・ん・ば・れ！	名詞	
＠なついろ	夏色えがおで1,2,Jump!	名詞	
まめふぇす	豆フェス	名詞	
＠まめふぇす1	Mermaid festa vol.1	名詞	
わたはな	私花	名詞	
＠わたはな	私たちは未来の花	名詞	
＠すぴか	スピカテリブル	名詞	
あいたい	愛太	名詞	
＠あいたい	愛は太陽じゃない？	名詞	
＠もうない	もうひとりじゃないよ	名詞	
＠もぎゅっと	もぎゅっと“love”で接近中！	名詞	
あいばん	愛ばん	名詞	
＠あいばん	愛してるばんざーい！	名詞	
まめふぇす2	豆フェス2	名詞	
＠まめふぇす2	Mermaid festa vol.2 〜Passionate〜	名詞	
さむらい	サムライ	名詞	
＠さむらい	Someday of my life	名詞	
＠Soml	Someday of my life	名詞	
＠りんがべー	恋のシグナル Rin rin rin!	名詞	
おとめしき	乙女式	名詞	
＠おとめしき	乙女式れんあい塾	名詞	
＠まほうつかい	まほうつかいはじめました！	名詞	
＠じゅんあい	純愛レンズ	名詞	
こくはくびより	告白日和
＠こくはくびより	告白日和、です！	名詞	
＠ぶるべり	ぶる〜べりぃ♥とれいん	名詞	
＠ぶるとれ	ぶる〜べりぃ♥とれいん	名詞	
へぶん	ヘブン	名詞	
＠へぶん	孤独なHeaven	名詞	
そるげ	ソルゲ	名詞	
＠そるげ	soldier game	名詞	
＠ゆうき	勇気のReason	名詞	
＠ありふれ	ありふれた悲しみの果て	名詞	
＠WR	Wonderful Rush	名詞	
らぶぴ	ラブピ	名詞	
＠らぶぴ	Oh,Love&Peace!	名詞	
＠Ltmh	Listen to my heart!!	名詞	
＠asN	after school NAVIGATORS	名詞	
ぼくいま	僕今	名詞	
＠ぼくいま	僕らは今のなかで	名詞	
＠WS	WILD STARS	名詞	
＠せいしゅん	きっと青春が聞こえる	名詞	
＠かぐや	輝夜の城で踊りたい	名詞	
＠すすめ	ススメ→トゥモロウ	名詞	
すただ	スタダ	名詞	
＠すただ	START:DASH!!	名詞	
これさむ	これサム
＠これさむ	これからのSomeday	名詞	
＠Wz	Wonder zone	名詞	
ゆめゆめゆめ	夢夢夢
＠ゆめゆめゆめ	夢なき夢は夢じゃない	名詞	
＠わちゃどぅー	Private Wars	名詞	
＠のーぶら	No brand girls	名詞	
＠あねもね	Anemone heart	名詞	
＠えんじぇー	Beat in Angel	名詞	
＠びねつ	微熱からMystery	名詞	
きみくせ	キミくせ	名詞	
＠きみくせ	キミのくせに！	名詞	
＠CP	Cutie Panther	名詞	
なつおわ	夏終わ	名詞	
＠なつおわ	夏、終わらないで。	名詞	
＠にこぷり	にこぷり女子道	名詞	
＠Pgp	Pure girls project	名詞	
あんばら	アンバラ	名詞	
＠あんばら	UNBALANCED LOVE	名詞	
＠はなぞの	硝子の花園	名詞	
＠LB	LONELIEST BABY	名詞	
＠ぷわぷわ	ぷわぷわーお！	名詞	
＠Mすた	Music S.T.A.R.T!!	名詞	
らぶれす	ラブレス	名詞	
＠らぶれす	LOVELESS WORLD	名詞	
ものず	モノズ	名詞	
＠ものず	タカラモノズ	名詞	
ぱららい	パラライ	名詞	
＠ぱららい	Paradise Live	名詞	
えんぱれ	エンパレ	名詞	
＠えんぱれ	ENDLESS PARADE	名詞	
それぼく	それ僕	名詞	
＠それぼく	それは僕たちの奇跡	名詞	
＠ああむじょう	だってだって噫無情	名詞	
ああむじょう	噫無情	名詞	
＠ああむじょう	だってだって噫無情	名詞	
＠どんとき	どんなときもずっと	名詞	
からぼ	カラボ	名詞	
＠からぼ	COLORFUL VOICE	名詞	
ゆめとび	ユメトビ	名詞	
＠ゆめとび	ユメノトビラ	名詞	
＠SSS	SENTIMENTAL StepS	名詞	
＠うぃんがべー	Love wing bell	名詞	
だんすた	ダンスタ	名詞	
＠だんすた	Dancing stars on me!	名詞	
しあわせ	シアワセ	名詞	
＠しあわせ	シアワセ行きのSMILING!	名詞	
きらせん	キラセン	名詞
＠きらせん	KiRa-KiRa Sensation!	名詞	
はぴめ	ハピメ	名詞	
＠はぴめ	Happy maker!	名詞	
＠じしゃく	ずるいよMagnetic today	名詞	
＠くるりん	くるりんMIRACLE	名詞	
しゃんしゃわ	シャンシャワ	名詞	
＠しゃんしゃわ	Shangri-La Shower	名詞	
＠るてし	るてしキスキしてる	名詞	
すとらば	ストラバ	名詞	
＠すとらば	Storm in Lover	名詞	
＠もしから	もしもからきっと	名詞	
＠ずっとも	永遠フレンズ	名詞	
＠ないちんげーる	小夜啼鳥恋詩	名詞	
すきすき	好き好き	名詞	
＠すきすき	好きですが好きですか？	名詞	
あきそら	秋空	名詞	
＠あきそら	秋のあなたの空遠く	名詞	
＠はぴねす	ふたりハピネス	名詞	
ふゆくれ	冬くれ	名詞	
＠ふゆくれ	冬がくれた予感	名詞	
とらばす	トラバス	名詞	
＠とらばす	Trouble Busters	名詞	
そしぺ	そしペ	名詞	
＠そしぺ	そして最後のページには	名詞	
＠CDCG	CheerDay CheerGirl!　	名詞	
＠さいれん	silent tonight	名詞	
おなほし	同星	名詞	
＠おなほし	同じ星が見たい	名詞	
KKE	かしこいかわいいエリーチカ	名詞	
いえろーだよ	ｲﾞｴﾞﾛﾞｰﾞﾀﾞﾖﾞｫﾞｫﾞｫﾞ!	感動詞	
にじがさきがくえんすくーるあいどるどうこうかい	虹ヶ咲学園スクールアイドル同好会	名詞	
にじがさきがくえん	虹ヶ咲学園	名詞	
にじがさき	虹ヶ咲	名詞	
